ཀུམ | གཟུགས་མི་འགྱུར་བ_ཐ་མི་དད་པ+བྱ་ཚིག_###
ཀེར | གཟུགས་མི་འགྱུར་བ_ཐ་མི་དད་པ
ཀྲུགས | གཟུགས་མི་འགྱུར་བ_ཐ་མི་དད་པ
ཀླན | གཟུགས་མི་འགྱུར་བ_ཐ་དད་པ
ཀླལ | གཟུགས་མི་འགྱུར་བ_ཐ་མི་དད་པ
ཀླས | གཟུགས་མི་འགྱུར་བ_ཐ་དད་པ
ཀླུབ | ཀླུབ_ད་ལྟ་བ།_ཐ་དད་པ
ཀླུབས | ཀླུབ_སྐུལ་ཚིག_ཐ་དད་པ
ཀློག | ཀློག_ད་ལྟ་བ།_ཐ་དད་པ
ཀློགས | ཀློག_སྐུལ་ཚིག_ཐ་དད་པ
ཀློད | གཟུགས་མི་འགྱུར་བ_ཐ་དད་པ
ཁུག | ཁུག_ད་ལྟ་བ།_ཐ་མི་དད་པ+འགུགས_སྐུལ་ཚིག_ཐ་དད་པ+འགུགས_སྐུལ་ཚིག_###+ཁུག_མ་འོངས་པ།_ཐ་མི་དད་པ
ཁུགས | ཁུག_འདས་པ།_ཐ་མི་དད་པ
ཁུན | གཟུགས་མི་འགྱུར་བ_ཐ་མི་དད་པ+འཁུན_འབྲི་ཚུལ
ཁུམ | འགུམ_སྐུལ་ཚིག_ཐ་དད་པ
ཁུམས | བྱ་ཚིག_ཐ་མི་དད་པ+འཁུམས_འབྲི་ཚུལ
ཁུར | ཁུར_འདས་པ།_ཐ་དད་པ+ཁུར_སྐུལ་ཚིག_ཐ་དད་པ+འཁུར_འདས་པ།_ཐ་དད་པ+འཁུར_སྐུལ་ཚིག_ཐ་དད་པ
ཁེ | གཟུགས་མི་འགྱུར་བ_ཐ་མི་དད་པ
ཁེག | ཁེག_མ་འོངས་པ།_ཐ་མི་དད་པ+ཁེག_ད་ལྟ་བ།_ཐ་མི་དད་པ
ཁེགས | ཁེག_འདས་པ།_ཐ་མི་དད་པ
ཁེང | ཁེང_མ་འོངས་པ།_ཐ་མི་དད་པ+ཁེང_མ་འོངས་པ།_###+ཁེང_ད་ལྟ་བ།_ཐ་མི་དད་པ+ཁེང_ད་ལྟ་བ།_###
ཁེངས | ཁེང_འདས་པ།_ཐ་མི་དད་པ+ཁེང_འདས་པ།_###
ཁེད | གཟུགས་མི་འགྱུར་བ_ཐ་མི་དད་པ
ཁེན | གཟུགས་མི་འགྱུར་བ_ཐ་མི་དད་པ
ཁེབ | ཁེབ_ད་ལྟ་བ།_ཐ་མི་དད་པ+ཁེབ_མ་འོངས་པ།_ཐ་མི་དད་པ
ཁེབས | ཁེབ_འདས་པ།_ཐ་མི་དད་པ
ཁེར | བྱ་ཚིག_###+ཀེར_འབྲི་ཚུལ
ཁེལ | འཁེལ_འདས་པ།_###
ཁོག | འགོག_སྐུལ་ཚིག_ཐ་དད་པ+འགོག_སྐུལ་ཚིག_###
ཁོང | འགེངས_སྐུལ་ཚིག_ཐ་དད་པ
ཁོད | འགད_སྐུལ་ཚིག_ཐ་དད་པ+འགོད_སྐུལ་ཚིག_ཐ་དད་པ
ཁོན | གཟུགས་མི་འགྱུར་བ_ཐ་མི་དད་པ+འཁོན_འབྲི་ཚུལ
ཁོབ | འགེབ_སྐུལ་ཚིག_###+འགེབ_སྐུལ་ཚིག_ཐ་དད་པ
ཁོར | འགེར_སྐུལ་ཚིག_ཐ་དད་པ+འགེར_སྐུལ་ཚིག_###+དགར_སྐུལ་ཚིག_###
ཁོལ | འཁོལ_སྐུལ་ཚིག_ཐ་དད་པ+འགེལ_སྐུལ་ཚིག_###+འཁེལ_སྐུལ་ཚིག_###+འཁོལ_སྐུལ་ཚིག_###+འཁེལ_སྐུལ་ཚིག_ཐ་དད་པ+ཁོལ_འདས་པ།_ཐ་མི་དད་པ+ཁོལ_ད་ལྟ་བ།_ཐ་མི་དད་པ
ཁོས | འགས_སྐུལ་ཚིག_ཐ་དད་པ
ཁྱག | གཟུགས་མི་འགྱུར་བ_ཐ་དད་པ
ཁྱགས | འཁྱགས_འབྲི་ཚུལ+བྱ་ཚིག_ཐ་མི་དད་པ
ཁྱབ | གཟུགས་མི་འགྱུར་བ_ཐ་མི་དད་པ
ཁྱིགས | འཁྱིག_སྐུལ་ཚིག_ཐ་དད་པ
ཁྱེ | ཁྱེ_ད་ལྟ་བ།_ཐ་དད་པ+ཁྱེས_མ་འོངས་པ།_ཐ་དད་པ+ཁྱེས_ད་ལྟ་བ།_ཐ་དད་པ+ཁྱེ_མ་འོངས་པ།_ཐ་དད་པ
ཁྱེད | གཟུགས་མི་འགྱུར་བ_ཐ་མི་དད་པ+འགྱེད_སྐུལ་ཚིག_###
ཁྱེར | འཁྱེར_སྐུལ་ཚིག_ཐ་དད་པ+ཁྱེར_སྐུལ་ཚིག_ཐ་དད་པ+ཁྱེར_འདས་པ།_ཐ་དད་པ+འཁྱེར_འདས་པ།_ཐ་དད་པ
ཁྱེས | འགྱེད_སྐུལ་ཚིག_ཐ་དད་པ+ཁྱེས_འདས་པ།_ཐ་དད་པ+ཁྱེ_སྐུལ་ཚིག_ཐ་དད་པ+ཁྱེས_སྐུལ་ཚིག_ཐ་དད་པ+འགྱེད_སྐུལ་ཚིག_###+ཁྱེ_འདས་པ།_ཐ་དད་པ
ཁྱོག | གཟུགས་མི་འགྱུར་བ_ཐ་མི་དད་པ+ཁྱོག_ད་ལྟ་བ།_ཐ་དད་པ
ཁྱོགས | ཁྱོག_སྐུལ་ཚིག_ཐ་དད་པ+འགྱོག_སྐུལ་ཚིག_ཐ་དད་པ
ཁྲིད | འཁྲིད_སྐུལ་ཚིག_ཐ་དད་པ+ཁྲིད_སྐུལ་ཚིག_ཐ་དད་པ+ཁྲིད_འདས་པ།_ཐ་དད་པ+འཁྲིད_སྐུལ་ཚིག_###+འཁྲིད_འདས་པ།_ཐ་དད་པ
ཁྲིལ | འཁྲིལ_འབྲི་ཚུལ+གཟུགས་མི་འགྱུར་བ_ཐ་མི་དད་པ
ཁྲུངས | བྱ་ཚིག_###
ཁྲུལ | གཟུགས་མི་འགྱུར་བ_ཐ་མི་དད་པ
ཁྲུས | འཁྲུད_སྐུལ་ཚིག_ཐ་དད་པ
ཁྲེམས | གཟུགས་མི་འགྱུར་བ_ཐ་མི་དད་པ
ཁྲེལ | གཟུགས་མི་འགྱུར་བ_ཐ་མི་དད་པ
ཁྲོ | ཁྲོས_མ་འོངས་པ།_ཐ་དད་པ+ཁྲོས_ད་ལྟ་བ།_ཐ་དད་པ+ཁྲོ_མ་འོངས་པ།_ཐ་མི་དད་པ+ཁྲོ_ད་ལྟ་བ།_ཐ་མི་དད་པ
ཁྲོག | གཟུགས་མི་འགྱུར་བ_ཐ་མི་དད་པ
ཁྲོབ | འཁྲབ_སྐུལ་ཚིག_ཐ་དད་པ
ཁྲོབས | འཁྲབ_སྐུལཚིག_འབྲི་ཚུལ
ཁྲོམ | ཁྲོམ_སྐུལ་ཚིག_ཐ་དད་པ+འགྲེམ_སྐུལ་ཚིག_ཐ་དད་པ
ཁྲོལ | འཁྲོལ_སྐུལ་ཚིག_ཐ་དད་པ+འགྲོལ_སྐུལ་ཚིག_ཐ་དད་པ+འགྲེལ_སྐུལ་ཚིག_ཐ་དད་པ+འཁྲོལ_སྐུལ་ཚིག_###
ཁྲོས | ཁྲོ_འདས་པ།_ཐ་མི་དད་པ+ཁྲོས_འདས་པ།_ཐ་དད་པ+ཁྲོ_སྐུལ་ཚིག_ཐ་མི་དད་པ+ཁྲོས_སྐུལ་ཚིག_ཐ་དད་པ
གང | གཟུགས་མི་འགྱུར་བ_ཐ་མི་དད་པ
གཅག | གཅོག_མ་འོངས་པ།_ཐ་དད་པ+འཇག_མ་འོངས་པ།_ཐ་དད་པ+གཅོག_མ་འོངས་པ།_###
གཅད | གཅོད_མ་འོངས་པ།_ཐ་མི་དད་པ+གཅོད_མ་འོངས་པ།_ཐ་དད་པ+གཅོད_མ་འོངས་པ།_###
གཅར | གཅར_མ་འོངས་པ།_ཐ་དད་པ+གཅར_མ་འོངས་པ།_###+གཅར_ད་ལྟ་བ།_ཐ་དད་པ+གཅར_ད་ལྟ་བ།_ཐ་མི་དད་པ+གཅར_ད་ལྟ་བ།_###+གཅར_མ་འོངས་པ།_ཐ་མི་དད་པ+གཅར_འདས་པ།_ཐ་དད་པ
གཅི | གཅི_མ་འོངས་པ།_ཐ་དད་པ+གཅིས_ད་ལྟ་བ།_ཐ་དད་པ+གཅི_ད་ལྟ་བ།_ཐ་དད་པ+གཅིས_མ་འོངས་པ།_ཐ་དད་པ
གཅིར | འཆིར_མ་འོངས་པ།_ཐ་དད་པ+འཆིར_མ་འོངས་པ།_###
གཅིལ | གཟུགས་མི་འགྱུར་བ_ཐ་དད་པ
གཅིས | གཅི_འདས་པ།_ཐ་དད་པ+གཅིས_འདས་པ།_ཐ་དད་པ+གཅི_སྐུལ་ཚིག_ཐ་དད་པ+གཅིས_སྐུལ་ཚིག_ཐ་དད་པ
གཅུ | གཅུས_མ་འོངས་པ།_ཐ་དད་པ+གཅུ_ད་ལྟ་བ།_ཐ་དད་པ+གཅུས_ད་ལྟ་བ།_ཐ་དད་པ+གཅུ_མ་འོངས་པ།_ཐ་དད་པ
གཅུགས | གཟུགས་མི་འགྱུར་བ_ཐ་མི་དད་པ
གཅུད | གཟུགས་མི་འགྱུར་བ_ཐ་དད་པ
གཅུན | འཆུན_མ་འོངས་པ།_ཐ་དད་པ+འཇུན_མ་འོངས་པ།_ཐ་དད་པ
གཅུར | འཇུར_མ་འོངས་པ།_###+འཇུར_མ་འོངས་པ།_ཐ་དད་པ
གཅུས | གཅུས_སྐུལ་ཚིག_ཐ་དད་པ+འཆུ_སྐུལ་ཚིག_###+གཅུ_འདས་པ།_ཐ་དད་པ+གཅུས_འདས་པ།_ཐ་དད་པ+གཅུ_སྐུལ་ཚིག_ཐ་དད་པ
གཅེས | གཟུགས་མི་འགྱུར་བ_ཐ་དད་པ
གཅོག | གཅོག_ད་ལྟ་བ།_ཐ་དད་པ+གཅོག_ད་ལྟ་བ།_###
གཅོད | གཅོད_ད་ལྟ་བ།_ཐ་མི་དད་པ+གཅོད_ད་ལྟ་བ།_###+གཅོད_ད་ལྟ་བ།_ཐ་དད་པ
གཅོམ | གཅོམ_ད་ལྟ་བ།_ཐ་དད་པ
གཅོར | གཅར_སྐུལ་ཚིག_ཐ་དད་པ+གཅར_སྐུལ་ཚིག_ཐ་མི་དད་པ
གཅོལ | གཟུགས་མི་འགྱུར་བ_ཐ་དད་པ
གཉག | གཉོག_མ་འོངས་པ།_###
གཉགས | གཉོག_འདས་པ།_###
གཉད | གཉོད_མ་འོངས་པ།_ཐ་དད་པ+གཉོད_འདས་པ།_ཐ་དད་པ
གཉིད | གཟུགས་མི་འགྱུར་བ_ཐ་མི་དད་པ
གཉིལ | གཟུགས་མི་འགྱུར་བ_ཐ་མི་དད་པ
གཉུལ | གཟུགས་མི་འགྱུར་བ_ཐ་མི་དད་པ
གཉེར | གཟུགས་མི་འགྱུར་བ_ཐ་དད་པ
གཉེལ | གཟུགས་མི་འགྱུར་བ_ཐ་མི་དད་པ
གཉོག | གཉོག_ད་ལྟ་བ།_ཐ་དད་པ+གཉོག_ད་ལྟ་བ།_###+གཉོགས_ད་ལྟ་བ།_ཐ་དད་པ+གཉོག_མ་འོངས་པ།_ཐ་དད་པ+གཉོགས_མ་འོངས་པ།_ཐ་དད་པ
གཉོགས | གཉོགས_སྐུལ་ཚིག_ཐ་དད་པ+གཉོག_སྐུལ་ཚིག_ཐ་དད་པ+གཉོག_འདས་པ།_ཐ་དད་པ+གཉོག_སྐུལ་ཚིག_###+གཉོགས_འདས་པ།_ཐ་དད་པ
གཉོད | གཉོད_སྐུལ་ཚིག_ཐ་དད་པ+གཉོད_ད་ལྟ་བ།_ཐ་དད་པ
གཏག | གཏག_མ་འོངས་པ།_###+གཏག_ད་ལྟ་བ།_###+གཏག_ད་ལྟ་བ།_ཐ་དད་པ+གཏག_མ་འོངས་པ།_ཐ་དད་པ
གཏགས | གཏག_འདས་པ།_###+གཏག_འདས་པ།_ཐ་དད་པ
གཏང | གཏོང_མ་འོངས་པ།_ཐ་དད་པ+གཏོང_མ་འོངས་པ།_###
གཏད | གཏོད_ད་ལྟ་བ།_###+གཏོད_འདས་པ།_###+གཏོད_མ་འོངས་པ།_###
གཏན | གཏན_མ་འོངས་པ།_ཐ་དད་པ+གཏན_འདས་པ།_ཐ་དད་པ+གཏན_ད་ལྟ་བ།_ཐ་དད་པ
གཏམས | གཏམས_མ་འོངས་པ།_###+གཏམས_འདས་པ།_ཐ་དད་པ+གཟུགས་མི་འགྱུར་བ_ཐ་མི་དད་པ+གཏམས_ད་ལྟ་བ།_ཐ་དད་པ+གཏམས_མ་འོངས་པ།_ཐ་དད་པ+གཏམས_འདས་པ།_###+གཏམས_ད་ལྟ་བ།_###
གཏའ | གཏའ_མ་འོངས་པ།_ཐ་དད་པ+གཏས_ད་ལྟ་བ།_ཐ་དད་པ+གཏས_མ་འོངས་པ།_ཐ་དད་པ+གཏའ_ད་ལྟ་བ།_ཐ་དད་པ
གཏར | གཏར_འདས་པ།_ཐ་དད་པ+གཏར_མ་འོངས་པ།_ཐ་དད་པ+གཏར_ད་ལྟ་བ།_ཐ་དད་པ
གཏས | གཏའ_སྐུལ་ཚིག_ཐ་དད་པ+གཏའ_འདས།_ཐ་དད་པ+གཏས_འདས་པ།_ཐ་དད་པ+གཏས_སྐུལ་ཚིག_ཐ་དད་པ
གཏི | བྱ་ཚིག_ཐ་དད་པ
གཏིག | གཏིག_ད་ལྟ་བ།_ཐ་དད་པ
གཏིགས | གཏིག_སྐུལ་ཚིག_ཐ་དད་པ
གཏིབ | གཏིབ_ད་ལྟ་བ།_ཐ་དད་པ+གཏིབས_མ་འོངས་པ།_ཐ་དད་པ+གཏིབ_མ་འོངས་པ།_ཐ་དད་པ+གཏིབས_ད་ལྟ་བ།_ཐ་དད་པ
གཏིབས | གཏིབས_འདས་པ།_ཐ་དད་པ+གཏིབས_སྐུལ་ཚིག_ཐ་དད་པ+གཏིབ_སྐུལ་ཚིག_ཐ་དད་པ+གཏིབ_འདས་པ།_ཐ་དད་པ
གཏིམ | གཟུགས་མི་འགྱུར་བ_ཐ་དད་པ
གཏུག | གཏུག_ད་ལྟ་བ།_ཐ་མི་དད་པ+གཏུག_ད་ལྟ་བ།_###+གཏུག_མ་འོངས་པ།_ཐ་མི་དད་པ+གཏུག_ད་ལྟ་བ།_ཐ་དད་པ+གཏུག_མ་འོངས་པ།_###+གཏུག_མ་འོངས་པ།_ཐ་དད་པ+གཏུགས_ད་ལྟ་བ།_ཐ་དད་པ+གཏུགས_མ་འོངས་པ།_ཐ་དད་པ
གཏུགས | གཏུག_སྐུལ་ཚིག_ཐ་དད་པ+གཏུག_འདས་པ།_ཐ་དད་པ+གཏུགས_སྐུལ་ཚིག_ཐ་དད་པ+གཏུག_འདས་པ།_###+གཏུག_འདས་པ།_ཐ་མི་དད་པ+གཏུགས_འདས་པ།_ཐ་དད་པ+གཏུག_སྐུལ་ཚིག_ཐ་མི་དད་པ+གཏུག_སྐུལ་ཚིག_###
གཏུབ | གཏུབས_མ་འོངས་པ།_ཐ་དད་པ+གཏུབས_ད་ལྟ་བ།_ཐ་དད་པ+གཏུབ_ད་ལྟ་བ།_ཐ་དད་པ+གཏུབ_མ་འོངས་པ།_ཐ་དད་པ
གཏུབས | གཏུབས_འདས་པ།_ཐ་དད་པ+གཏུབ_འདས་པ།_ཐ་དད་པ+གཏུབས_སྐུལ་ཚིག_ཐ་དད་པ+གཏུབ_སྐུལ་ཚིག_ཐ་དད་པ
གཏུམ | ཐུམ_མ་འོངས་པ།_ཐ་དད་པ+འཐུམ_མ་འོངས་པ།_ཐ་དད་པ
གཏུལ | གཟུགས་མི་འགྱུར་བ_ཐ་དད་པ
གཏོག | གཏོག_ད་ལྟ་བ།_###+གཏོག_མ་འོངས་པ།_###+གཏོག_མ་འོངས་པ།_ཐ་དད་པ+གཏོགས_མ་འོངས་པ།_ཐ་དད་པ+གཏོགས_ད་ལྟ་བ།_ཐ་དད་པ+གཏོག_ད་ལྟ་བ།_ཐ་དད་པ
གཏོགས | གཏོག_སྐུལ་ཚིག_ཐ་དད་པ+གཏག_སྐུལ་ཚིག_ཐ་དད་པ+གཏོག_སྐུལ་ཚིག_###+གཏོག_འདས་པ།_ཐ་དད་པ+གཏག_སྐུལ་ཚིག_###+གཟུགས་མི་འགྱུར་བ_ཐ་མི་དད་པ+གཏོགས_སྐུལ་ཚིག_ཐ་དད་པ+གཏོག_འདས་པ།_###+གཏོགས_འདས་པ།_ཐ་དད་པ
གཏོང | གཏོང_ད་ལྟ་བ།_###+གཏོང_ད་ལྟ་བ།_ཐ་དད་པ
གཏོད | གཏོད_ད་ལྟ་བ།_###+གཏོད_སྐུལ་ཚིག_###+གཏོད_མ་འོངས་པ།_###+འདོད_མ་འོངས་པ།_###
གཏོན | གཏན_སྐུལ་ཚིག_ཐ་དད་པ
གཏོམས | གཏམས_སྐུལ་ཚིག_###+གཏམས_སྐུལ་ཚིག_ཐ་དད་པ
གཏོར | གཏར_སྐུལ་ཚིག_ཐ་དད་པ+བྱ་ཚིག_###+གཟུགས་མི་འགྱུར་བ_ཐ་དད་པ
གདག | འདོག_མ་འོངས་པ།_ཐ་དད་པ
གདགས | འདོགས_མ་འོངས་པ།_###+འདོགས_མ་འོངས་པ།_ཐ་དད་པ
གདང | གདང_མ་འོངས་པ།_ཐ་དད་པ+གདང_ད་ལྟ་བ།_ཐ་དད་པ
གདངས | གཟུགས་མི་འགྱུར་བ_ཐ་མི་དད་པ+གདང_འདས་པ།_ཐ་དད་པ
གདབ | འདེབས_མ་འོངས་པ།_###+འདེབས_མ་འོངས་པ།_ཐ་དད་པ
གདམ | འདེམ_མ་འོངས་པ།_ཐ་དད་པ
གདམས | གདམས_མ་འོངས་པ།_ཐ་དད་པ+གདམས_འདས་པ།_ཐ་དད་པ+འདོམས_མ་འོངས་པ།_ཐ་དད་པ+འདོམས_འདས་པ།_ཐ་དད་པ
གདལ | བདལ_ད་ལྟ་བ།_ཐ་དད་པ+གདལ_ད་ལྟ་བ།_###+གདལ_ད་ལྟ་བ།_ཐ་དད་པ
གདས | གཟུགས་མི་འགྱུར་བ_ཐ་དད་པ
གདིང | འདིང_མ་འོངས་པ།_ཐ་དད་པ
གདུ | གདུ_མ་འོངས་པ།_ཐ་དད་པ+གདུས_ད་ལྟ་བ།_ཐ་དད་པ+གདུས_མ་འོངས་པ།_ཐ་དད་པ+གདུ_ད་ལྟ་བ།_ཐ་དད་པ
གདུག | གདུག_ད་ལྟ་བ།_ཐ་དད་པ
གདུང | གདུང_ད་ལྟ་བ།_ཐ་མི་དད་པ+གདུང_མ་འོངས་པ།_ཐ་མི་དད་པ+གདུང_ད་ལྟ་བ།_###+གདུང_མ་འོངས་པ།_###
གདུངས | གདུང_འདས་པ།_ཐ་མི་དད་པ+གདུང_འདས་པ།_###
གདུད | འདུད_མ་འོངས་པ།_ཐ་དད་པ
གདུལ | འདུལ_མ་འོངས་པ།_ཐ་དད་པ+འདུལ_མ་འོངས་པ།_###
གདུས | གདུ_འདས་པ།_ཐ་དད་པ+གདུ_སྐུལ་ཚིག_ཐ་དད་པ+གདུས_སྐུལ་ཚིག_ཐ་དད་པ+གདུས_འདས་པ།_ཐ་དད་པ
གདེག | འདེགས_མ་འོངས་པ།_ཐ་དད་པ
གདེང | གདེང_མ་འོངས་པ།_ཐ་དད་པ+གདེང_ད་ལྟ་བ།_ཐ་དད་པ+གདེངས_མ་འོངས་པ།_ཐ་དད་པ+གདེངས_ད་ལྟ་བ།_ཐ་དད་པ
གདེངས | གདེང_སྐུལ་ཚིག_ཐ་དད་པ+གདེངས_འདས་པ།_ཐ་དད་པ+གདེང_འདས་པ།_ཐ་དད་པ+གདེངས_སྐུལ་ཚིག_ཐ་དད་པ
གདོངས | གདང_སྐུལ་ཚིག_ཐ་དད་པ
གདོད | གཏོད_མའོངསཔ_འབྲི་ཚུལ+ཐོད_མ་འོངས་པ།_ཐ་དད་པ+བྱ་ཚིག_ཐ་དད་པ
གདོན | འདོན_མ་འོངས་པ།_ཐ་དད་པ+འདོན_མ་འོངས་པ།_###
གདོམས | འདེམ_སྐུལཚིག_འབྲི་ཚུལ
གདོལ | གདལ_སྐུལ་ཚིག_ཐ་དད་པ+གདལ_སྐུལ་ཚིག_###
གནག | གཟུགས་མི་འགྱུར་བ_ཐ་མི་དད་པ
གནང | གནང_ད་ལྟ་བ།_ཐ་དད་པ+གནང_འདས་པ།_ཐ་དད་པ+གནང_མ་འོངས་པ།_ཐ་དད་པ
གནན | གནོན_མ་འོངས་པ_འབྲི་ཚུལ
གནར | གནར_མ་འོངས་པ།_###+གནར_འདས་པ།_###+གནར_འདས་པ།_ཐ་མི་དད་པ+གནར_ད་ལྟ་བ།_###+གནར_མ་འོངས་པ།_ཐ་མི་དད་པ+གནར_ད་ལྟ་བ།_ཐ་མི་དད་པ
གནས | གཟུགས་མི་འགྱུར་བ_ཐ་མི་དད་པ
གནོང | གནོང_ད་ལྟ་བ།_ཐ་དད་པ+གནོང_མ་འོངས་པ།_ཐ་མི་དད་པ+གནོངས_མ་འོངས་པ།_###+གནོང_ད་ལྟ་བ།_ཐ་མི་དད་པ+གནོངས_ད་ལྟ་བ།_###+གནོང_མ་འོངས་པ།_ཐ་དད་པ
གནོངས | གནོངས_འདས་པ།_###+གནོང_སྐུལ་ཚིག_ཐ་དད་པ+གནོང_འདས་པ།_ཐ་དད་པ+གནོངས_སྐུལ་ཚིག_###+གནང_སྐུལ་ཚིག_ཐ་དད་པ+གནོང_འདས་པ།_ཐ་མི་དད་པ
གནོད | བྱ་ཚིག_###+གཟུགས་མི་འགྱུར་བ_ཐ་དད་པ
གནོན | གནོན_ད་ལྟ་བ།_ཐ་དད་པ+མནན_ད་ལྟ་བ།_ཐ་དད་པ
གནོར | གནར_སྐུལ་ཚིག_ཐ་མི་དད་པ+གནར_སྐུལ་ཚིག_###
གནོས | ནོད_སྐུལ་ཚིག_ཐ་དད་པ
གབ | གབ_འདས་པ།_ཐ་དད་པ+གཟུགས་མི་འགྱུར་བ_ཐ་མི་དད་པ+གབ_མ་འོངས་པ།_ཐ་དད་པ+གབ_ད་ལྟ་བ།_ཐ་དད་པ
གཙག | གཙག_མ་འོངས་པ།_ཐ་དད་པ+གཙག_ད་ལྟ་བ།_###+འཚག_མ་འོངས་པ།_ཐ་དད་པ+གཙག_ད་ལྟ་བ།_ཐ་དད་པ+གཙག_མ་འོངས་པ།_###
གཙགས | གཙག_འདས་པ།_ཐ་དད་པ+གཙག_འདས་པ།_###
གཙབ | གཙབ_མ་འོངས་པ།_ཐ་དད་པ+གཙབ_ད་ལྟ་བ།_ཐ་དད་པ
གཙབས | གཙབ_འདས་པ།_ཐ་དད་པ
གཙི | གཙིས_མ་འོངས་པ།_ཐ་དད་པ+གཙི_ད་ལྟ་བ།_ཐ་དད་པ+བྱ་ཚིག_###+གཙིས_ད་ལྟ་བ།_ཐ་དད་པ+གཙི_མ་འོངས་པ།_ཐ་དད་པ
གཙིག | གཙིག_ད་ལྟ་བ།_ཐ་དད་པ+གཙིགས_མ་འོངས་པ།_ཐ་དད་པ+གཙིགས_ད་ལྟ་བ།_ཐ་དད་པ+གཙིག_མ་འོངས་པ།_ཐ་དད་པ
གཙིགས | གཙིག_འདས་པ།_ཐ་དད་པ+གཙིགས_སྐུལ་ཚིག_ཐ་དད་པ+གཙིག_སྐུལ་ཚིག_ཐ་དད་པ+གཙིགས_འདས་པ།_ཐ་དད་པ
གཙིར | འཚིར_མའོངསཔ_འབྲི་ཚུལ+བྱ་ཚིག_ཐ་དད་པ
གཙིས | གཙིས_སྐུལ་ཚིག_ཐ་དད་པ+གཙི_འདས་པ།_ཐ་དད་པ+གཙི_སྐུལ་ཚིག_ཐ་དད་པ+གཙིས_འདས་པ།_ཐ་དད་པ
གཙུབ | གཙུབ_ད་ལྟ་བ།_ཐ་དད་པ+གཙུབ_མ་འོངས་པ།_ཐ་དད་པ+གཙུབས_མ་འོངས་པ།_ཐ་དད་པ+གཙུབ_ད་ལྟ་བ།_###+གཙུབ_མ་འོངས་པ།_###+གཙུབས_ད་ལྟ་བ།_ཐ་དད་པ
གཙུབས | གཙུབས_འདས་པ།_ཐ་དད་པ+གཙུབ_འདས་པ།_###+གཙུབ_སྐུལ་ཚིག_###+གཙུབས_སྐུལ་ཚིག_ཐ་དད་པ+གཙུབ_འདས་པ།_ཐ་དད་པ+གཙུབ_སྐུལ་ཚིག_ཐ་དད་པ
གཙེ | གཙེས_ད་ལྟ་བ།_ཐ་དད་པ+གཙེ_ད་ལྟ་བ།_ཐ་དད་པ+གཙེ_མ་འོངས་པ།_ཐ་དད་པ+གཙེས_མ་འོངས་པ།_ཐ་དད་པ
གཙེར | གཟུགས་མི་འགྱུར་བ_ཐ་དད་པ
གཙེས | གཙེས_སྐུལ་ཚིག_ཐ་དད་པ+གཙེ_སྐུལ་ཚིག_ཐ་དད་པ+གཙེ_འདས་པ།_ཐ་དད་པ+གཙེས_འདས་པ།_ཐ་དད་པ
གཙོག | འཚོག_མ་འོངས་པ།_ཐ་དད་པ+བཙོག_འབྲི་ཚུལ
གཙོགས | གཙག_སྐུལ་ཚིག_ཐ་དད་པ+གཙག_སྐུལ་ཚིག_###
གཙོབས | གཙབ_སྐུལ་ཚིག_ཐ་དད་པ
གཞག | འཇོག_མ་འོངས་པ།_ཐ་དད་པ+འཇོག_མ་འོངས་པ།_###
གཞབ | འཇབ_མ་འོངས་པ།_ཐ་དད་པ+གཞབ_མ་འོངས་པ།_###+གཞབ_ད་ལྟ་བ།_###
གཞའ | གཟུགས་མི་འགྱུར་བ_ཐ་མི་དད་པ+བྱ་ཚིག_###
གཞར | གཞར_ད་ལྟ་བ།_ཐ་དད་པ+གཞར_ད་ལྟ་བ།_###+བཞར_ད་ལྟ་བ།_ཐ་དད་པ
གཞལ | འཇལ_མ་འོངས་པ།_###+འཇལ_མ་འོངས་པ།_ཐ་དད་པ
གཞིག | གཞིགས_མ་འོངས་པ།_ཐ་དད་པ+གཞིགས_ད་ལྟ་བ།_ཐ་དད་པ+གཞིག_མ་འོངས་པ།_ཐ་དད་པ+འཇིག_མ་འོངས་པ།_ཐ་དད་པ+གཞིག_ད་ལྟ་བ།_ཐ་དད་པ
གཞིགས | གཞིག_འདས་པ།_ཐ་དད་པ+གཞིགས_འདས་པ།_ཐ་དད་པ+གཞིགས_སྐུལ་ཚིག_ཐ་དད་པ+གཞིག_སྐུལ་ཚིག_ཐ་དད་པ
གཞིབ | འཇིབ_མ་འོངས་པ།_ཐ་དད་པ
གཞིབས | འཇིབ_འབྲི་ཚུལ+བྱ་ཚིག_ཐ་དད་པ
གཞིལ | འཇིལ_མ་འོངས་པ།_ཐ་དད་པ
གཞུ | གཞུ_ད་ལྟ་བ།_ཐ་དད་པ+གཞུ_མ་འོངས་པ།_ཐ་དད་པ+གཞུས_ད་ལྟ་བ།_ཐ་དད་པ+གཞུས_མ་འོངས་པ།_ཐ་དད་པ
གཞུག | འཇུག_མ་འོངས་པ།_ཐ་དད་པ
གཞུར | བཞུར_མ་འོངས་པ།_ཐ་དད་པ+གཞུར_སྐུལ་ཚིག_ཐ་དད་པ+བཞུར_ད་ལྟ་བ།_ཐ་དད་པ+གཞུར_ད་ལྟ་བ།_ཐ་དད་པ+བཞུར_སྐུལ་ཚིག_ཐ་དད་པ+གཞུར_མ་འོངས་པ།_ཐ་དད་པ
གཞུས | གཞུས_སྐུལ་ཚིག_ཐ་དད་པ+གཞུ_འདས་པ།_ཐ་དད་པ+གཞུ_སྐུལ་ཚིག_ཐ་དད་པ+གཞུས_འདས་པ།_ཐ་དད་པ
གཞེན | གཟུགས་མི་འགྱུར་བ_ཐ་དད་པ
གཞེར | གཟུགས་མི་འགྱུར་བ_ཐ་དད་པ
གཞེས | གཟུགས་མི་འགྱུར་བ_ཐ་མི་དད་པ
གཞོག | གཞོག_མ་འོངས་པ།_ཐ་དད་པ+གཞོག_ད་ལྟ་བ།_ཐ་དད་པ
གཞོགས | བཞོག_འབྲི་ཚུལ+བྱ་ཚིག_ཐ་དད་པ
གཞོབ | གཞབ_སྐུལ་ཚིག_###+གཞོབས_ད་ལྟ་བ།_ཐ་དད་པ+གཞོབས_མ་འོངས་པ།_ཐ་དད་པ+གཞོབ_ད་ལྟ་བ།_ཐ་དད་པ+གཞོབ_མ་འོངས་པ།_ཐ་དད་པ+གཞབ_སྐུལཚིག_འབྲི་ཚུལ
གཞོབས | གཞོབས_སྐུལ་ཚིག_ཐ་དད་པ+གཞོབ_འདས་པ།_ཐ་དད་པ+གཞོབ_སྐུལ་ཚིག_ཐ་དད་པ+གཞོབས_འདས་པ།_ཐ་དད་པ
གཞོམ | འཇོམས_མ་འོངས་པ།_ཐ་དད་པ
གཞོར | གཞར_སྐུལཚིག_འབྲི་ཚུལ
གཞོལ | གཟུགས་མི་འགྱུར་བ_ཐ་མི་དད་པ+གཟུགས་མི་འགྱུར་བ_###
གཞོས | འཇོ_སྐུལཚིག_འབྲི་ཚུལ
གཟག | གཟག_མ་འོངས་པ།_ཐ་དད་པ+གཟག_ད་ལྟ་བ།_ཐ་དད་པ
གཟགས | གཟག_འདས་པ།_ཐ་དད་པ
གཟན | གཟན_ད་ལྟ་བ།_###+གཟན_འདས་པ།_###+གཟན_མ་འོངས་པ།_###+གཟུགས་མི་འགྱུར་བ_ཐ་དད་པ
གཟབ | གཟབ_ད་ལྟ་བ།_ཐ་དད་པ+གཟབ_མ་འོངས་པ།_ཐ་དད་པ
གཟར | འཛར_མ་འོངས་པ།_ཐ་མི་དད་པ+གཟར_འདས་པ།_ཐ་དད་པ+འཛར_འདས་པ།_ཐ་མི་དད་པ+གཟར_ད་ལྟ་བ།_ཐ་དད་པ+འཛར_མ་འོངས་པ།_ཐ་དད་པ+གཟར_མ་འོངས་པ།_ཐ་དད་པ
གཟས | གཟུགས་མི་འགྱུར་བ_ཐ་མི་དད་པ
གཟིགས | གཟུགས་མི་འགྱུར་བ_ཐ་དད་པ
གཟིང | གཟེང_འབྲི་ཚུལ+བྱ་ཚིག_ཐ་མི་དད་པ
གཟིམ | གཟིམ_ད་ལྟ་བ།_ཐ་མི་དད་པ+གཟིམས_མ་འོངས་པ།_ཐ་མི་དད་པ+གཟིམ_མ་འོངས་པ།_ཐ་མི་དད་པ+གཟིམས_ད་ལྟ་བ།_ཐ་མི་དད་པ
གཟིམས | གཟིམས_འདས་པ།_ཐ་མི་དད་པ+གཟིམ_སྐུལ་ཚིག_ཐ་མི་དད་པ+གཟིམ_འདས་པ།_ཐ་མི་དད་པ+གཟིམས_སྐུལ་ཚིག_ཐ་མི་དད་པ
གཟིར | གཟུགས་མི་འགྱུར་བ_ཐ་དད་པ
གཟུགས | འཛུགས_མ་འོངས་པ།_ཐ་དད་པ+འཛུགས_མ་འོངས་པ།_###
གཟུང | འཛིན_མ་འོངས་པ།_ཐ་དད་པ+འཛིན_མ་འོངས་པ།_###
གཟུད | འཛུད_མ་འོངས་པ།_ཐ་དད་པ
གཟུམ | གཟུམ_མ་འོངས་པ།_ཐ་དད་པ
གཟུར | འཛུར_མ་འོངས་པ།_ཐ་མི་དད་པ
གཟེག | བྱ་ཚིག_ཐ་མི་དད་པ
གཟེང | གཟེང_མ་འོངས་པ།_ཐ་མི་དད་པ+གཟེང_ད་ལྟ་བ།_ཐ་མི་དད་པ
གཟེངས | གཟེང_འདས་པ།_ཐ་མི་དད་པ
གཟེད | འཛེད_མ་འོངས་པ།_ཐ་དད་པ
གཟེམ | བྱ་ཚིག_ཐ་དད་པ+འཛེམ_མའོངསཔ_འབྲི་ཚུལ
གཟེར | གཟུགས་མི་འགྱུར་བ_ཐ་མི་དད་པ+འཛར_སྐུལ་ཚིག_ཐ་དད་པ
གཟོ | གཟོ_ད་ལྟ་བ།_ཐ་དད་པ+གཟོ_མ་འོངས་པ།_ཐ་དད་པ+གཟོས_མ་འོངས་པ།_ཐ་དད་པ+གཟོས_ད་ལྟ་བ།_ཐ་དད་པ
གཟོགས | གཟག_སྐུལ་ཚིག_ཐ་དད་པ
གཟོན | གཟན_སྐུལ་ཚིག_###
གཟོབ | གཟབ_དལྟབ_འབྲི་ཚུལ+བྱ་ཚིག_ཐ་དད་པ
གཟོབས | གཟབ_སྐུལ་ཚིག_ཐ་དད་པ
གཟོར | གཟར_སྐུལ་ཚིག_ཐ་དད་པ
གཟོས | གཟོས_སྐུལ་ཚིག_ཐ་དད་པ+གཟོས_འདས་པ།_ཐ་དད་པ+གཟོ_འདས་པ།_ཐ་དད་པ+གཟོ_སྐུལ་ཚིག_ཐ་དད་པ
གཡབ | གཡབས_མ་འོངས་པ།_ཐ་དད་པ+གཡོབ_མ་འོངས་པ།_ཐ་དད་པ
གཡབས | གཡབས_འདས་པ།_ཐ་དད་པ+གཡོབ_འདས་པ།_ཐ་དད་པ
གཡར | གཡར_ད་ལྟ་བ།_ཐ་དད་པ+གཡར_འདས་པ།_ཐ་དད་པ+གཡར_མ་འོངས་པ།_ཐ་དད་པ
གཡལ | གཟུགས་མི་འགྱུར་བ_ཐ་མི་དད་པ
གཡིག | གཡིག_ད་ལྟ་བ།_ཐ་མི་དད་པ+གཡིག_མ་འོངས་པ།_ཐ་མི་དད་པ
གཡིགས | གཡིག_འདས་པ།_ཐ་མི་དད་པ
གཡུག | གཡུག_མ་འོངས་པ།_###+གཡུག_ད་ལྟ་བ།_###+གཡུག_མ་འོངས་པ།_ཐ་དད་པ+གཡུགས_ད་ལྟ་བ།_ཐ་དད་པ+གཡུགས_མ་འོངས་པ།_ཐ་དད་པ+གཡུག_ད་ལྟ་བ།_ཐ་དད་པ
གཡུགས | གཡུག_འདས་པ།_ཐ་དད་པ+གཡུགས_སྐུལ་ཚིག_ཐ་དད་པ+གཡུག_འདས་པ།_###+གཡུག_སྐུལ་ཚིག_ཐ་དད་པ+གཡུག_སྐུལ་ཚིག_###+གཡུགས_འདས་པ།_ཐ་དད་པ
གཡུར | གཟུགས་མི་འགྱུར་བ_ཐ་མི་དད་པ
གཡེང | གཡེང_མ་འོངས་པ།_###+གཡེངས_ད་ལྟ་བ།_ཐ་དད་པ+གཡེང_ད་ལྟ་བ།_ཐ་དད་པ+གཡེང_མ་འོངས་པ།_ཐ་དད་པ+གཡེངས_མ་འོངས་པ།_ཐ་དད་པ+གཡེང_ད་ལྟ་བ།_ཐ་མི་དད་པ+གཡེང_ད་ལྟ་བ།_###+གཡེང_མ་འོངས་པ།_ཐ་མི་དད་པ
གཡེངས | གཡེང_འདས་པ།_###+གཡེང_འདས་པ།_ཐ་དད་པ+གཡེངས_འདས་པ།_ཐ་དད་པ+གཡེངས_སྐུལ་ཚིག_ཐ་དད་པ+གཡེང_འདས་པ།_ཐ་མི་དད་པ+གཡེང_སྐུལ་ཚིག_ཐ་དད་པ
གཡེམ | གཟུགས་མི་འགྱུར་བ_ཐ་དད་པ
གཡེལ | བྱ་ཚིག_###+གཟུགས་མི་འགྱུར་བ_ཐ་མི་དད་པ
གཡོ | གཡོ_མ་འོངས་པ།_ཐ་མི་དད་པ+གཡོ_ད་ལྟ་བ།_ཐ་མི་དད་པ+གཡོས_མ་འོངས་པ།_ཐ་མི་དད་པ+གཡོས_མ་འོངས་པ།_ཐ་དད་པ+གཡོ_ད་ལྟ་བ།_ཐ་དད་པ+གཡོས_ད་ལྟ་བ།_ཐ་དད་པ+གཡོས_ད་ལྟ་བ།_ཐ་མི་དད་པ+གཡོ_མ་འོངས་པ།_ཐ་དད་པ
གཡོག | གཡོག_ད་ལྟ་བ།_###+གཡོག_ད་ལྟ་བ།_ཐ་དད་པ+གཡོག_མ་འོངས་པ།_ཐ་དད་པ+གཡོགས_མ་འོངས་པ།_ཐ་དད་པ+གཡོག_མ་འོངས་པ།_###+གཡོགས_ད་ལྟ་བ།_ཐ་དད་པ
གཡོགས | གཡོག_འདས་པ།_ཐ་དད་པ+གཡོགས_འདས་པ།_ཐ་དད་པ+གཡོག_སྐུལ་ཚིག_###+གཡོགས_སྐུལ་ཚིག_ཐ་དད་པ+གཡོག_སྐུལ་ཚིག_ཐ་དད་པ+གཡོག_འདས་པ།_###
གཡོབ | གཡབས_ད་ལྟ་བ།_ཐ་དད་པ+གཡོབ_ད་ལྟ་བ།_ཐ་དད་པ
གཡོབས | གཡོབ_སྐུལ་ཚིག_ཐ་དད་པ+གཡབས_སྐུལ་ཚིག_ཐ་དད་པ
གཡོར | གཡར_སྐུལ་ཚིག_ཐ་དད་པ
གཡོས | གཡོ_སྐུལ་ཚིག_ཐ་མི་དད་པ+གཡོ_འདས་པ།_ཐ་དད་པ+གཡོས_སྐུལ་ཚིག_ཐ་དད་པ+གཡོས_འདས་པ།_ཐ་མི་དད་པ+གཡོས_འདས་པ།_ཐ་དད་པ+གཡོ_སྐུལ་ཚིག_ཐ་དད་པ+གཡོ_འདས་པ།_ཐ་མི་དད་པ+གཡོས_སྐུལ་ཚིག_ཐ་མི་དད་པ
གཤག | གཤོག_མ་འོངས་པ།_ཐ་དད་པ
གཤགས | གཟུགས་མི་འགྱུར་བ_ཐ་མི་དད་པ+བྱ་ཚིག_###+གཤོག_འདས་པ།_ཐ་དད་པ
གཤར | གཤར_ད་ལྟ་བ།_ཐ་མི་དད་པ+གཤར_མ་འོངས་པ།_ཐ་མི་དད་པ
གཤལ | བཤལ_འབྲི་ཚུལ+བྱ་ཚིག_ཐ་དད་པ
གཤིབ | གཤིབ_ད་ལྟ་བ།_###+གཤིབས_ད་ལྟ་བ།_ཐ་དད་པ+གཤིབ_མ་འོངས་པ།_###+གཤིབ_ད་ལྟ་བ།_ཐ་དད་པ+གཤིབ_མ་འོངས་པ།_ཐ་དད་པ+གཤིབས_མ་འོངས་པ།_ཐ་དད་པ
གཤིབས | གཤིབ_སྐུལ་ཚིག_ཐ་དད་པ+གཤིབས_སྐུལ་ཚིག_ཐ་དད་པ+གཤིབ_འདས་པ།_ཐ་དད་པ+གཤིབས_འདས་པ།_ཐ་དད་པ+གཤིབ_འདས་པ།_###+གཤིབ_སྐུལ་ཚིག_###
གཤུ | གཤུ_ད་ལྟ་བ།_ཐ་དད་པ
གཤུང | གཤུང_ད་ལྟ་བ།_ཐ་དད་པ
གཤུད | བཤུད_མ་འོངས་པ།_###+བཤུད_ད་ལྟ་བ།_###+གཤུད_མ་འོངས་པ།_ཐ་དད་པ+གཤུད_ད་ལྟ་བ།_ཐ་དད་པ
གཤུམ | བཤུམ_འབྲི་ཚུལ+བྱ་ཚིག_ཐ་མི་དད་པ
གཤུར | གཤུར_ད་ལྟ་བ།_ཐ་དད་པ+བཤུར_ད་ལྟ་བ།_ཐ་དད་པ
གཤེ | གཤེ_མ་འོངས་པ།_ཐ་དད་པ+གཤེས_མ་འོངས་པ།_ཐ་དད་པ+གཤེ_ད་ལྟ་བ།_ཐ་དད་པ+གཤེས_ད་ལྟ་བ།_ཐ་དད་པ
གཤེགས | གཟུགས་མི་འགྱུར་བ_ཐ་མི་དད་པ+བྱ་ཚིག_###
གཤེར | གཟུགས་མི་འགྱུར་བ_ཐ་དད་པ+གཤེར_ད་ལྟ་བ།_###+བཤེར_ད་ལྟ་བ།_ཐ་དད་པ
གཤེས | གཤེ_འདས་པ།_ཐ་དད་པ+གཤེས_འདས་པ།_ཐ་དད་པ+གཤེ_སྐུལ་ཚིག_ཐ་དད་པ+གཤེས_སྐུལ་ཚིག_ཐ་དད་པ
གཤོ | གཤོས_ད་ལྟ་བ།_ཐ་དད་པ+གཤོ_ད་ལྟ་བ།_###+གཤོས_མ་འོངས་པ།_ཐ་དད་པ+གཤོ_མ་འོངས་པ།_###+གཤོ_ད་ལྟ་བ།_ཐ་དད་པ
གཤོག | གཤོག_ད་ལྟ་བ།_ཐ་དད་པ
གཤོགས | གཤོག_སྐུལ་ཚིག_ཐ་དད་པ
གཤོང | གཤོང_ད་ལྟ་བ།_###+གཤོང_ད་ལྟ་བ།_ཐ་དད་པ
གཤོངས | གཤོང_སྐུལ་ཚིག_###+གཤོང_སྐུལ་ཚིག_ཐ་དད་པ
གཤོམ | གཤོམ_ད་ལྟ་བ།_ཐ་དད་པ+གཤོམ_ད་ལྟ་བ།_###
གཤོར | གཤོར_ད་ལྟ་བ།_###+གཤོར_ད་ལྟ་བ།_ཐ་དད་པ+གཤར_སྐུལ་ཚིག_ཐ་མི་དད་པ+བཤོར_ད་ལྟ་བ།_ཐ་དད་པ+བཤོར_སྐུལ་ཚིག_ཐ་དད་པ+གཤོར_སྐུལ་ཚིག_ཐ་དད་པ+གཤོར_སྐུལ་ཚིག_###
གཤོལ | གཤོལ_སྐུལཚིག_འབྲི་ཚུལ
གཤོས | གཤོས_འདས་པ།_ཐ་དད་པ+གཤོས_སྐུལ་ཚིག_ཐ་དད་པ+གཤོ_འདས་པ།_###+གཤོ_སྐུལ་ཚིག_###
གས | གཟུགས་མི་འགྱུར་བ_ཐ་མི་དད་པ
གསག | གསོག_མའོངསཔ_འབྲི་ཚུལ+བྱ་ཚིག_ཐ་དད་པ
གསང | གསང_མ་འོངས་པ།_ཐ་དད་པ+གསང_འདས་པ།_ཐ་དད་པ+གསང_ད་ལྟ་བ།_ཐ་དད་པ
གསངས | གསང_འདསཔ_འབྲི་ཚུལ+བྱ་ཚིག_ཐ་དད་པ
གསད | གསོད_མ་འོངས་པ།_###+གསོད_མ་འོངས་པ།_ཐ་དད་པ
གསན | གསན_ད་ལྟ་བ།_ཐ་དད་པ+གསན_འདས་པ།_ཐ་དད་པ+གསན_མ་འོངས་པ།_ཐ་དད་པ
གསབ | གསོབ_འབྲི་ཚུལ+བྱ་ཚིག_ཐ་དད་པ
གསིག | གསིག_ད་ལྟ་བ།_ཐ་དད་པ
གསིགས | གསིག_སྐུལཚིག_འབྲི་ཚུལ
གསིང | གསིང_ད་ལྟ་བ།_ཐ་དད་པ
གསིངས | གསིང_སྐུལ་ཚིག_ཐ་དད་པ
གསིར | བསིར_ད་ལྟ་བ།_ཐ་དད་པ+གསིར_ད་ལྟ་བ།_ཐ་དད་པ+གསིར_སྐུལ་ཚིག_ཐ་དད་པ+བསིར_སྐུལ་ཚིག_ཐ་དད་པ
གསིལ | གསིལ_ད་ལྟ་བ།_###+བསིལ_སྐུལ་ཚིག_ཐ་དད་པ+གསིལ_སྐུལ་ཚིག_###+བསིལ_ད་ལྟ་བ།_ཐ་དད་པ+གསིལ_ད་ལྟ་བ།_ཐ་དད་པ+གསིལ_སྐུལ་ཚིག_ཐ་དད་པ
གསུང | གསུང_ད་ལྟ་བ།_ཐ་དད་པ+གསུངས_མ་འོངས་པ།_ཐ་དད་པ+གསུང_མ་འོངས་པ།_ཐ་དད་པ+གསུངས_ད་ལྟ་བ།_ཐ་དད་པ
གསུངས | གསུང_འདས་པ།_ཐ་དད་པ+གསུངས_སྐུལ་ཚིག_ཐ་དད་པ+གསུངས_འདས་པ།_ཐ་དད་པ+གསུང_སྐུལ་ཚིག_ཐ་དད་པ
གསུབ | གསུབ_མ་འོངས་པ།_ཐ་དད་པ+གསུབས_ད་ལྟ་བ།_ཐ་དད་པ+གསུབས_མ་འོངས་པ།_ཐ་དད་པ+གསུབ_ད་ལྟ་བ།_ཐ་དད་པ
གསུབས | གསུབས_སྐུལ་ཚིག_ཐ་དད་པ+གསུབ_སྐུལ་ཚིག_ཐ་དད་པ+གསུབས_འདས་པ།_ཐ་དད་པ
གསུར | བྱ་ཚིག_ཐ་དད་པ
གསེ | གསེས_ད་ལྟ་བ།_ཐ་དད་པ+གསེ_མ་འོངས་པ།_ཐ་དད་པ+གསེ_ད་ལྟ་བ།_ཐ་དད་པ+གསེས_མ་འོངས་པ།_ཐ་དད་པ
གསེག | གསེག_ད་ལྟ་བ།_ཐ་དད་པ
གསེད | བསེད_མ་འོངས་པ།_ཐ་དད་པ+བསེད_ད་ལྟ་བ།_ཐ་དད་པ+གསེད_ད་ལྟ་བ།_ཐ་དད་པ+གསེད_མ་འོངས་པ།_ཐ་དད་པ
གསེས | གསེ_འདས་པ།_ཐ་དད་པ+གསེ_སྐུལ་ཚིག_ཐ་དད་པ+གསེས_འདས་པ།_ཐ་དད་པ+གསེས_སྐུལ་ཚིག_ཐ་དད་པ
གསོ | གསོ_མ་འོངས་པ།_ཐ་དད་པ+གསོ_ད་ལྟ་བ།_ཐ་དད་པ+གསོས_མ་འོངས་པ།_ཐ་དད་པ+གསོ_ད་ལྟ་བ།_###+གསོ_མ་འོངས་པ།_###+གསོས_ད་ལྟ་བ།_ཐ་དད་པ
གསོག | གསོག_ད་ལྟ་བ།_###+གསོག_ད་ལྟ་བ།_ཐ་དད་པ
གསོགས | གསེག_སྐུལ་ཚིག_ཐ་དད་པ
གསོང | བྱ་ཚིག_ཐ་དད་པ+གསང_འབྲི་ཚུལ
གསོངས | གསང_སྐུལ་ཚིག_ཐ་དད་པ
གསོད | གསོད_ད་ལྟ་བ།_ཐ་དད་པ+གསོད_ད་ལྟ་བ།_###
གསོན | གསན_སྐུལ་ཚིག_ཐ་དད་པ+གཟུགས་མི་འགྱུར་བ_ཐ་མི་དད་པ
གསོབ | གསོབ_ད་ལྟ་བ།_###+གསོབ_ད་ལྟ་བ།_ཐ་དད་པ
གསོར | བསོར_སྐུལ་ཚིག_ཐ་དད་པ+གསོར_སྐུལ་ཚིག_###+གསོར_ད་ལྟ་བ།_###+བསར_ད་ལྟ་བ།_ཐ་དད་པ+བསར_སྐུལ་ཚིག_ཐ་དད་པ+གསོར_སྐུལ་ཚིག_ཐ་དད་པ+གསོར_ད་ལྟ་བ།_ཐ་དད་པ+བསོར_ད་ལྟ་བ།_ཐ་དད་པ
གསོལ | གཟུགས་མི་འགྱུར་བ_ཐ་མི་དད་པ+བྱ་ཚིག_###
གསོས | གསོ_འདས་པ།_###+གསོས_འདས་པ།_ཐ་དད་པ+གསོས_སྐུལ་ཚིག_ཐ་དད་པ+གསོ_འདས་པ།_ཐ་དད་པ+གསོ_སྐུལ་ཚིག_###+གསོ_སྐུལ་ཚིག_ཐ་དད་པ
གུམ | གཟུགས་མི་འགྱུར་བ_ཐ་མི་དད་པ
གོ | བྱ་ཚིག_###+གཟུགས་མི་འགྱུར་བ_ཐ་དད་པ
གོག | གཟུགས་མི་འགྱུར་བ_ཐ་མི་དད་པ+བྱ་ཚིག_###
གོད | གཟུགས་མི་འགྱུར་བ_ཐ་དད་པ
གོན | གཟུགས་མི་འགྱུར་བ_ཐ་དད་པ
གོབ | གབ_སྐུལ་ཚིག_ཐ་དད་པ
གོམས | གཟུགས་མི་འགྱུར་བ_ཐ་མི་དད་པ
གོལ | གཟུགས་མི་འགྱུར་བ_ཐ་མི་དད་པ
གོས | གཟུགས་མི་འགྱུར་བ_ཐ་མི་དད་པ
གྱིམ | བྱ་ཚིག_###
གྱིས | བགྱིད_སྐུལ་ཚིག_ཐ་དད་པ
གྱུར | འགྱུར_འདས་པ།_ཐ་མི་དད་པ
གྱེད | གཟུགས་མི་འགྱུར་བ_ཐ་མི་དད་པ
གྱེར | བྱ་ཚིག_ཐ་དད་པ
གྱེས | གྱེས_འདས་པ།_ཐ་མི་དད་པ+གྱེས_སྐུལ་ཚིག_ཐ་མི་དད་པ+འགྱེ_འདས་པ།_ཐ་མི་དད་པ+འགྱེ_སྐུལ་ཚིག_ཐ་མི་དད་པ
གྱོན | གཟུགས་མི་འགྱུར་བ_ཐ་དད་པ
གྱོལ | གཟུགས་མི་འགྱུར་བ_ཐ་མི་དད་པ
གྲག | གྲག_ད་ལྟ་བ།_ཐ་མི་དད་པ+གྲག_མ་འོངས་པ།_ཐ་མི་དད་པ
གྲགས | གྲག_འདས་པ།_ཐ་མི་དད་པ
གྲང | གཟུགས་མི་འགྱུར་བ_ཐ་མི་དད་པ
གྲིམ | གྲིམས_ད་ལྟ་བ།_ཐ་མི་དད་པ+གྲིམས_མ་འོངས་པ།_ཐ་མི་དད་པ
གྲིམས | གྲིམས_འདས་པ།_ཐ་མི་དད་པ+གྲིམས_སྐུལ་ཚིག_ཐ་མི་དད་པ
གྲིལ | གཟུགས་མི་འགྱུར་བ_ཐ་མི་དད་པ+འགྲིལ_འདས་པ།_ཐ་མི་དད་པ
གྲུག | གྲུག_མ་འོངས་པ།_ཐ་མི་དད་པ+གྲུག_ད་ལྟ་བ།_ཐ་མི་དད་པ+གྲུག_ད་ལྟ་བ།_###+གྲུག_མ་འོངས་པ།_###
གྲུགས | གྲུག_འདས་པ།_###+གྲུག_འདས་པ།_ཐ་མི་དད་པ
གྲུངས | བགྲུང_དལྟབ_འབྲི་ཚུལ+བྱ་ཚིག_ཐ་དད་པ
གྲུབ | འགྲུབ_འདས་པ།_ཐ་མི་དད་པ
གྲུམ | གྲུམ_མ་འོངས་པ།_ཐ་མི་དད་པ+གྲུམ_ད་ལྟ་བ།_ཐ་མི་དད་པ
གྲུམས | གྲུམ_འདས་པ།_ཐ་མི་དད་པ
གྲུས | བགྲུད_སྐུལ་ཚིག_འབྲི་ཚུལ
གྲེམས | འགྲེམ_འབྲི་ཚུལ+བྱ་ཚིག_ཐ་དད་པ
གྲོངས | གཟུགས་མི་འགྱུར་བ_ཐ་མི་དད་པ
གྲོན | གཟུགས་མི་འགྱུར་བ_ཐ་དད་པ
གྲོལ | གཟུགས་མི་འགྱུར་བ_ཐ་མི་དད་པ+བྱ་ཚིག_###
གླ | གླ_མ་འོངས་པ།_ཐ་དད་པ+གླ_ད་ལྟ་བ།_ཐ་དད་པ
གླན | གློན_འདས་པ།_ཐ་དད་པ+གློན_མ་འོངས་པ།_###+གླན_འདས་པ།_ཐ་དད་པ+གློན_འདས་པ།_###+གློན_མ་འོངས་པ།_ཐ་དད་པ+གླན_མ་འོངས་པ།_ཐ་དད་པ
གླལ | གཟུགས་མི་འགྱུར་བ_ཐ་མི་དད་པ
གླས | གླ_འདས་པ།_ཐ་དད་པ
གླེང | གླེང_མ་འོངས་པ།_ཐ་དད་པ+གླེངས_ད་ལྟ་བ།_ཐ་དད་པ+གླེངས_མ་འོངས་པ།_ཐ་དད་པ+གླེང_ད་ལྟ་བ།_ཐ་དད་པ
གླེངས | གླེངས_འདས་པ།_ཐ་དད་པ+གླེང_འདས་པ།_ཐ་དད་པ
གླེབ | གླེབས_ད་ལྟ་བ།_ཐ་དད་པ+གླེབ_ད་ལྟ་བ།_###+གླེབ_མ་འོངས་པ།_###+གླེབ_མ་འོངས་པ།_ཐ་དད་པ+གླེབ_ད་ལྟ་བ།_ཐ་དད་པ+གླེབས_མ་འོངས་པ།_ཐ་དད་པ
གླེབས | གླེབས_འདས་པ།_ཐ་དད་པ+གླེབ_སྐུལ་ཚིག_ཐ་དད་པ+གླེབས_སྐུལ་ཚིག_ཐ་དད་པ+གླེབ_འདས་པ།_###+གླེབ_འདས་པ།_ཐ་དད་པ+གླེབ_སྐུལ་ཚིག_###
གློང | གློངས_ད་ལྟ་བ།_ཐ་དད་པ+གློངས_མ་འོངས་པ།_ཐ་དད་པ+གློང_ད་ལྟ་བ།_ཐ་དད་པ+གློང_མ་འོངས་པ།_ཐ་དད་པ
གློངས | གློང_འདས་པ།_ཐ་དད་པ+གློངས_སྐུལ་ཚིག_ཐ་དད་པ+གློངས_འདས་པ།_ཐ་དད་པ+གློང_སྐུལ་ཚིག_ཐ་དད་པ
གློད | བྱ་ཚིག_###+ཀློད_འབྲི་ཚུལ
གློན | གློན_ད་ལྟ་བ།_###+གློན_ད་ལྟ་བ།_ཐ་དད་པ+གློན_སྐུལ་ཚིག_###+གླན_ད་ལྟ་བ།_ཐ་དད་པ+གླན_སྐུལ་ཚིག_ཐ་དད་པ+གློན_སྐུལ་ཚིག_ཐ་དད་པ
གློས | གླ_སྐུལ་ཚིག_ཐ་དད་པ
ངར | གཟུགས་མི་འགྱུར་བ_ཐ་མི་དད་པ
ངལ | གཟུགས་མི་འགྱུར་བ_ཐ་མི་དད་པ
ངུ | ངུ_མ་འོངས་པ།_ཐ་མི་དད་པ+ངུས_ད་ལྟ་བ།_ཐ་མི་དད་པ+ངུ_ད་ལྟ་བ།_ཐ་མི་དད་པ+ངུས_མ་འོངས་པ།_ཐ་མི་དད་པ
ངུར | གཟུགས་མི་འགྱུར་བ_ཐ་མི་དད་པ
ངུས | ངུ_སྐུལ་ཚིག_ཐ་མི་དད་པ+ངུས_འདས་པ།_ཐ་མི་དད་པ+ངུ_འདས་པ།_ཐ་མི་དད་པ+ངུས_སྐུལ་ཚིག_ཐ་མི་དད་པ
ངེར | གཟུགས་མི་འགྱུར་བ_ཐ་དད་པ
ངེས | གཟུགས་མི་འགྱུར་བ_ཐ་མི་དད་པ
ངོམ | ངོམ_ད་ལྟ་བ།_ཐ་དད་པ+ངོམས_མ་འོངས་པ།_ཐ་དད་པ+ངོམས_ད་ལྟ་བ།_ཐ་དད་པ+ངོམ_མ་འོངས་པ།_ཐ་དད་པ
ངོམས | ངོམས_འདས་པ།_ཐ་དད་པ+གཟུགས་མི་འགྱུར་བ_ཐ་མི་དད་པ+ངོམ_འདས་པ།_ཐ་དད་པ+ངོམས_སྐུལ་ཚིག_ཐ་དད་པ+ངོམ_སྐུལ་ཚིག_ཐ་དད་པ
ཅིལ | འཇིལ_སྐུལཚིག_འབྲི་ཚུལ
ཅེམ | ཅེམ_ད་ལྟ་བ།_ཐ་དད་པ
ཅེམས | ཅེམ_སྐུལ་ཚིག_ཐ་དད་པ
ཅེར | ཅེར_སྐུལ་ཚིག_ཐ་དད་པ+བཅེར_སྐུལ་ཚིག_ཐ་དད་པ+ཅེར_སྐུལ་ཚིག_###+བཅེར_ད་ལྟ་བ།_ཐ་དད་པ+ཅེར_ད་ལྟ་བ།_###+ཅེར_ད་ལྟ་བ།_ཐ་དད་པ
ཆག | འཆག_འདས་པ།_ཐ་མི་དད་པ+འཆག_འདས་པ།_###
ཆགས | གཟུགས་མི་འགྱུར་བ_ཐ་མི་དད་པ+འཆག_འདས་པ།_###
ཆད | གཟུགས་མི་འགྱུར་བ_###+འཆད_འདས་པ།_ཐ་མི་དད་པ
ཆས | གཟུགས་མི་འགྱུར་བ_ཐ་མི་དད་པ
ཆིངས | ཆིངས_སྐུལ་ཚིག_ཐ་དད་པ
ཆིབས | འཆིབ_སྐུལ་ཚིག_ཐ་དད་པ
ཆིར | འཆིར_སྐུལ་ཚིག_ཐ་དད་པ+འཆིར_སྐུལ་ཚིག_###
ཆིལ | འཇིལ_སྐུལ་ཚིག_ཐ་དད་པ
ཆུག | འཇུག_སྐུལ་ཚིག_ཐ་དད་པ
ཆུགས | འཇུག_སྐུལ་ཚིག_འབྲི་ཚུལ
ཆུད | བྱ་ཚིག_###+གཟུགས་མི་འགྱུར་བ_ཐ་མི་དད་པ
ཆུན | འཇུན_སྐུལ་ཚིག_ཐ་དད་པ+འཆུན_སྐུལ་ཚིག_ཐ་དད་པ
ཆུབ | གཟུགས་མི་འགྱུར་བ_ཐ་མི་དད་པ
ཆུམ | འཇུམ_སྐུལ་ཚིག_འབྲི་ཚུལ
ཆུམས | འཇུམ_སྐུལ་ཚིག_ཐ་དད་པ
ཆུར | འཇུར_སྐུལ་ཚིག_###+འཇུར_སྐུལ་ཚིག_ཐ་དད་པ
ཆུས | བཅུས_སྐུལ་ཚིག_ཐ་དད་པ+འཆུ_སྐུལ་ཚིག_ཐ་དད་པ
ཆོག | འཇག_སྐུལ་ཚིག_ཐ་དད་པ+གཅོག_སྐུལ་ཚིག_###+གཅོག_སྐུལ་ཚིག_ཐ་དད་པ
ཆོགས | འཆག_སྐུལ་ཚིག_###
ཆོངས | བཅང_སྐུལ་ཚིག_ཐ་དད་པ+འཆང_སྐུལ་ཚིག_###+བཅིང_སྐུལ་ཚིག_ཐ་དད་པ+འཆིང_སྐུལ་ཚིག_ཐ་དད་པ+འཆང_སྐུལ་ཚིག_ཐ་དད་པ
ཆོད | འཆད_སྐུལ་ཚིག_ཐ་མི་དད་པ+གཅོད_སྐུལ་ཚིག_###+གཟུགས་མི་འགྱུར་བ_###+གཅོད_སྐུལ་ཚིག_ཐ་མི་དད་པ+གཅོད_སྐུལ་ཚིག_ཐ་དད་པ
ཆོབས | འཆབ_སྐུལ་ཚིག_ཐ་དད་པ
ཆོམ | འཇོམས_སྐུལ་ཚིག_ཐ་དད་པ
ཆོམས | གཅོམ_སྐུལ་ཚིག_ཐ་དད་པ
ཆོར | གཅར_སྐུལ་ཚིག_###
ཆོལ | འཆོལ_སྐུལ་ཚིག_###+འཆོལ_སྐུལ་ཚིག_ཐ་དད་པ
ཆོས | བཅའ_སྐུལ་ཚིག_ཐ་དད་པ+འཆའ_སྐུལ་ཚིག_###+འཆའ_སྐུལ་ཚིག_ཐ་མི་དད་པ+འཆོས_སྐུལ་ཚིག_###+བཅོས_སྐུལ་ཚིག_###+ཆོས_སྐུལ་ཚིག_ཐ་དད་པ+འཆའ_སྐུལ་ཚིག_ཐ་དད་པ+འཆོས_སྐུལ་ཚིག_ཐ་དད་པ
ཉ | གཟུགས་མི་འགྱུར་བ_ཐ་མི་དད་པ
ཉན | མཉན_ད་ལྟ་བ།_ཐ་དད་པ+ཉན_ད་ལྟ་བ།_ཐ་དད་པ
ཉམས | གཟུགས་མི་འགྱུར་བ_ཐ་མི་དད་པ
ཉར | ཉར_འདས་པ།_འབྲི་ཚུལ+ཉར_མ་འོངས་པ།_འབྲི་ཚུལ+ཉར_ད་ལྟ་བ།_འབྲི་ཚུལ
ཉལ | ཉལ_འདས་པ།_ཐ་མི་དད་པ+ཉལ_མ་འོངས་པ།_ཐ་མི་དད་པ+ཉལ_ད་ལྟ་བ།_ཐ་མི་དད་པ
ཉིལ | གཟུགས་མི་འགྱུར་བ_ཐ་མི་དད་པ
ཉུག | ཉུགས_ད་ལྟ་བ།_ཐ་དད་པ+ཉུག_ད་ལྟ་བ།_ཐ་དད་པ+ཉུག_ད་ལྟ་བ།_ཐ་མི་དད་པ+ཉུགས_མ་འོངས་པ།_ཐ་དད་པ+ཉུག_མ་འོངས་པ།_ཐ་དད་པ+ཉུགས_མ་འོངས་པ།_ཐ་མི་དད་པ+ཉུག_ད་ལྟ་བ།_###+ཉུག_མ་འོངས་པ།_ཐ་མི་དད་པ+ཉུག_མ་འོངས་པ།_###+ཉུགས_ད་ལྟ་བ།_ཐ་མི་དད་པ
ཉུགས | ཉུགས_སྐུལ་ཚིག_ཐ་མི་དད་པ+ཉུག_འདས་པ།_ཐ་མི་དད་པ+ཉུག_སྐུལ་ཚིག_ཐ་མི་དད་པ+ཉུག_འདས་པ།_ཐ་དད་པ+ཉུག_སྐུལ་ཚིག_###+ཉུགས_འདས་པ།_ཐ་དད་པ+ཉུག_འདས་པ།_###+ཉུགས_སྐུལ་ཚིག_ཐ་དད་པ+ཉུགས_འདས་པ།_ཐ་མི་དད་པ+ཉུག_སྐུལ་ཚིག_ཐ་དད་པ
ཉུལ | གཟུགས་མི་འགྱུར་བ_ཐ་མི་དད་པ+གཟུགས་མི་འགྱུར་བ_ཐ་དད་པ
ཉེད | མཉེས_ད་ལྟ་བ།_ཐ་དད་པ+ཉེད_ད་ལྟ་བ།_ཐ་དད་པ
ཉེན | གཟུགས་མི་འགྱུར་བ_ཐ་མི་དད་པ
ཉེས | གཟུགས་མི་འགྱུར་བ_ཐ་མི་དད་པ
ཉོ | ཉོ_མ་འོངས་པ།_ཐ་དད་པ+ཉོ_ད་ལྟ་བ།_ཐ་དད་པ+ཉོས_ད་ལྟ་བ།_ཐ་དད་པ+ཉོས_མ་འོངས་པ།_ཐ་དད་པ
ཉོན | ཉན_སྐུལ་ཚིག_ཐ་དད་པ+མཉན_སྐུལ་ཚིག_ཐ་དད་པ
ཉོབ | བྱ་ཚིག_ཐ་མི་དད་པ
ཉོར | ཉར_སྐུལ་ཚིག_འབྲི་ཚུལ
ཉོལ | ཉལ_སྐུལ་ཚིག_ཐ་མི་དད་པ
ཉོས | ཉོ_འདས་པ།_ཐ་དད་པ+ཉོས_འདས་པ།_ཐ་དད་པ+ཉོ_སྐུལ་ཚིག_ཐ་དད་པ+ཉོས_སྐུལ་ཚིག_ཐ་དད་པ
ཏིངས | འདིང_སྐུལཚིག_འབྲི་ཚུལ
ཐག | འཐག_འདས་པ།_ཐ་མི་དད་པ
ཐང | གཟུགས་མི་འགྱུར་བ_ཐ་མི་དད་པ
ཐར | གཟུགས་མི་འགྱུར་བ_ཐ་མི་དད་པ
ཐལ | གཟུགས་མི་འགྱུར་བ_ཐ་མི་དད་པ
ཐིགས | བྱ་ཚིག_ཐ་མི་དད་པ
ཐིང | འདིང_སྐུལ་ཚིག_འབྲི་ཚུལ
ཐིངས | གཟུགས་མི་འགྱུར་བ_ཐ་མི་དད་པ+བྱ་ཚིག_###
ཐིམ | གཟུགས་མི་འགྱུར་བ_ཐ་མི་དད་པ+འཐིམ_འདས་པ།_ཐ་མི་དད་པ
ཐུག | གཟུགས་མི་འགྱུར་བ_ཐ་མི་དད་པ+གཟུགས་མི་འགྱུར་བ_ཐ་དད་པ
ཐུངས | འཐུང_སྐུལཚིག_འབྲི་ཚུལ
ཐུད | འདུད_སྐུལ་ཚིག_ཐ་དད་པ
ཐུམ | འཐུམ_སྐུལ་ཚིག_ཐ་དད་པ+ཐུམ_སྐུལ་ཚིག_ཐ་དད་པ
ཐུམས | དུམ_སྐུལ་ཚིག_ཐ་དད་པ
ཐུལ | འདུལ_སྐུལ་ཚིག_###+འདུལ_སྐུལ་ཚིག_ཐ་དད་པ+ཐུལ_སྐུལ་ཚིག_###+ཐུལ_འདས་པ།_###
ཐུས | བཏུས_སྐུལ་ཚིག_ཐ་དད་པ+འཐུ_སྐུལ་ཚིག_ཐ་དད་པ
ཐེ | གཟུགས་མི་འགྱུར་བ_ཐ་མི་དད་པ
ཐེག | ཐེག_ད་ལྟ་བ།_ཐ་མི་དད་པ+འདེགས_སྐུལ་ཚིག_ཐ་དད་པ
ཐེགས | ཐེག_སྐུལ་ཚིག_ཐ་མི་དད་པ
ཐེངས | གཟུགས་མི་འགྱུར་བ_ཐ་མི་དད་པ
ཐེད | གཟུགས་མི་འགྱུར་བ_ཐ་མི་དད་པ
ཐེན | གཟུགས་མི་འགྱུར་བ_ཐ་མི་དད་པ
ཐེབས | གཟུགས་མི་འགྱུར་བ_ཐ་མི་དད་པ+བྱ་ཚིག_###
ཐེམ | ཐེམས_འབྲི་ཚུལ+བྱ་ཚིག_ཐ་མི་དད་པ
ཐེམས | འཐེམ_འདས་པ།_ཐ་མི་དད་པ+གཟུགས་མི་འགྱུར་བ_ཐ་མི་དད་པ
ཐོག | འདོག_སྐུལ་ཚིག_ཐ་དད་པ
ཐོགས | བྱ་ཚིག_###+འདོགས_སྐུལ་ཚིག_###+འདོགས_སྐུལ་ཚིག_ཐ་དད་པ+གཟུགས་མི་འགྱུར་བ_ཐ་མི་དད་པ+འཐོག_འདས་པ།_ཐ་མི་དད་པ+འཐོག_འདས་པ།_###
ཐོང | འདིང_སྐུལ་ཚིག_ཐ་དད་པ+གཏོང_སྐུལ་ཚིག_ཐ་དད་པ+གཏོང_སྐུལ་ཚིག_###
ཐོད | ཐོད_སྐུལ་ཚིག_ཐ་དད་པ+འདོད_སྐུལ་ཚིག_###
ཐོན | ཐོན_སྐུལ་ཚིག_ཐ་མི་དད་པ+གཟུགས་མི་འགྱུར་བ_###+ཐོན_འདས་པ།_ཐ་མི་དད་པ+འཐོན_འདས་པ།_ཐ་མི་དད་པ+འཐོན_སྐུལ་ཚིག_ཐ་མི་དད་པ+འདོན_སྐུལ་ཚིག_ཐ་དད་པ+འདོན_སྐུལ་ཚིག_###
ཐོབ | འདེབས_སྐུལ་ཚིག_###+འཐོབ_འདས་པ།_ཐ་མི་དད་པ+འདེབས_སྐུལ་ཚིག_ཐ་དད་པ
ཐོམ | འདམ_སྐུལ་ཚིག_ཐ་དད་པ
ཐོམས | སོམས_འབྲི་ཚུལ
ཐོར | འཐོར_འདས་པ།_ཐ་མི་དད་པ
ཐོས | གཟུགས་མི་འགྱུར་བ_ཐ་མི་དད་པ
དཀག | གཟུགས་མི་འགྱུར་བ_ཐ་མི་དད་པ
དཀུ | དཀུ_ད་ལྟ་བ།_ཐ་དད་པ+དཀུ_མ་འོངས་པ།_ཐ་མི་དད་པ+དཀུ_མ་འོངས་པ།_ཐ་དད་པ+དཀུ_ད་ལྟ་བ།_ཐ་མི་དད་པ
དཀུས | དཀུ_སྐུལ་ཚིག_ཐ་དད་པ+དཀུ_འདས་པ།_ཐ་མི་དད་པ+དཀུ_འདས་པ།_ཐ་དད་པ
དཀྱུ | དཀྱུ_མ་འོངས་པ།_ཐ་དད་པ+དཀྱུས_ད་ལྟ་བ།_ཐ་དད་པ+དཀྱུས_མ་འོངས་པ།_ཐ་དད་པ+དཀྱུ_ད་ལྟ་བ།_ཐ་དད་པ
དཀྱུས | དཀྱུས_འདས་པ།_ཐ་དད་པ+དཀྱུ_འདས་པ།_ཐ་དད་པ+དཀྱུ_སྐུལ་ཚིག_ཐ་དད་པ+དཀྱུས_སྐུལ་ཚིག_ཐ་དད་པ
དཀྱོག | དཀྱོག_ད་ལྟ་བ།_ཐ་དད་པ+དཀྱོགས_ད་ལྟ་བ།_ཐ་དད་པ+དཀྱོག_མ་འོངས་པ།_ཐ་དད་པ+དཀྱོགས_མ་འོངས་པ།_ཐ་དད་པ
དཀྱོགས | དཀྱོགས_འདས་པ།_ཐ་དད་པ+དཀྱོག_འདས་པ།_ཐ་དད་པ+དཀྱོག_སྐུལ་ཚིག_ཐ་དད་པ+དཀྱོགས_སྐུལ་ཚིག_ཐ་དད་པ
དཀྲབ | འཁྲབ_མ་འོངས་པ།_ཐ་དད་པ
དཀྲི | དཀྲི_མ་འོངས་པ།_ཐ་དད་པ+དཀྲིས_ད་ལྟ་བ།_ཐ་དད་པ+དཀྲི_ད་ལྟ་བ།_ཐ་དད་པ+དཀྲིས_མ་འོངས་པ།_ཐ་དད་པ+དཀྲི_མ་འོངས་པ།_###+དཀྲི_ད་ལྟ་བ།_###
དཀྲིག | དཀྲིགས_མ་འོངས་པ།_ཐ་དད་པ+དཀྲིག_མ་འོངས་པ།_ཐ་དད་པ+དཀྲིགས_ད་ལྟ་བ།_ཐ་དད་པ+དཀྲིག_ད་ལྟ་བ།_ཐ་དད་པ
དཀྲིགས | དཀྲིག_འདས་པ།_ཐ་དད་པ+དཀྲིགས_འདས་པ།_ཐ་དད་པ+དཀྲིགས_སྐུལ་ཚིག_ཐ་དད་པ+དཀྲིག_སྐུལ་ཚིག_ཐ་དད་པ
དཀྲིས | དཀྲི_སྐུལ་ཚིག_ཐ་དད་པ+དཀྲི_སྐུལ་ཚིག_###+དཀྲིས_འདས་པ།_ཐ་དད་པ+དཀྲི_འདས་པ།_ཐ་དད་པ+དཀྲི_འདས་པ།_###+དཀྲིས_སྐུལ་ཚིག_ཐ་དད་པ
དཀྲུག | དཀྲུག_མ་འོངས་པ།_###+དཀྲུགས_མ་འོངས་པ།_ཐ་དད་པ+དཀྲུག_ད་ལྟ་བ།_###+དཀྲུག_ད་ལྟ་བ།_ཐ་དད་པ+དཀྲུག_མ་འོངས་པ།_ཐ་དད་པ+དཀྲུགས_ད་ལྟ་བ།_ཐ་དད་པ
དཀྲུགས | དཀྲུག_སྐུལ་ཚིག_ཐ་དད་པ+དཀྲུགས_སྐུལ་ཚིག_ཐ་དད་པ+དཀྲུག_སྐུལ་ཚིག_###+དཀྲུག_འདས་པ།_ཐ་དད་པ+དཀྲུགས_འདས་པ།_ཐ་དད་པ+དཀྲུག_འདས་པ།_###
དཀྲུམ | དཀྲུམས_མ་འོངས་པ།_ཐ་དད་པ+དཀྲུམས_ད་ལྟ་བ།_ཐ་དད་པ+དཀྲུམ_ད་ལྟ་བ།_ཐ་དད་པ+དཀྲུམ_མ་འོངས་པ།_ཐ་དད་པ
དཀྲུམས | དཀྲུམ_འདས་པ།_ཐ་དད་པ+དཀྲུམས_འདས་པ།_ཐ་དད་པ+དཀྲུམ_སྐུལ་ཚིག_ཐ་དད་པ+དཀྲུམས_སྐུལ་ཚིག_ཐ་དད་པ
དཀྲོག | དཀྲོག_ད་ལྟ་བ།_###+དཀྲོག_ད་ལྟ་བ།_ཐ་དད་པ+དཀྲོག_མ་འོངས་པ།_###+དཀྲོགས_ད་ལྟ་བ།_ཐ་དད་པ+དཀྲོག_མ་འོངས་པ།_ཐ་དད་པ+དཀྲོགས_མ་འོངས་པ།_ཐ་དད་པ
དཀྲོགས | དཀྲོག_འདས་པ།_ཐ་དད་པ+དཀྲོག_སྐུལ་ཚིག_ཐ་དད་པ+དཀྲོགས_འདས་པ།_ཐ་དད་པ+དཀྲོག_འདས་པ།_###+དཀྲོགས_སྐུལ་ཚིག_ཐ་དད་པ+དཀྲོག_སྐུལ་ཚིག_###
དཀྲོལ | འཁྲོལ_མ་འོངས་པ།_###
དག | བྱ་ཚིག_###+འདག_འདས་པ།_ཐ་མི་དད་པ
དགག | འགོག_མ་འོངས་པ།_ཐ་དད་པ+འགོག_མ་འོངས་པ།_###
དགང | འགེངས_མ་འོངས་པ།_ཐ་དད་པ
དགད | འགད_མ་འོངས་པ།_###+འགད_མ་འོངས་པ།_ཐ་དད་པ
དགབ | འགེབ_མ་འོངས་པ།_ཐ་དད་པ+འགེབ_མ་འོངས་པ།_###
དགའ | གཟུགས་མི་འགྱུར་བ_ཐ་མི་དད་པ
དགར | དགར_ད་ལྟ་བ།_###+དགར_མ་འོངས་པ།_###+འགེར_མ་འོངས་པ།_###+འགེར_མ་འོངས་པ།_ཐ་དད་པ
དགལ | འགེལ_མ་འོངས་པ།_###
དགས | འགས_མ་འོངས་པ།_ཐ་དད་པ
དགུག | འགུགས_མ་འོངས་པ།_ཐ་དད་པ+འགུགས_མ་འོངས་པ།_###
དགུམ | འགུམ_མ་འོངས་པ།_ཐ་དད་པ
དགུར | གཟུགས་མི་འགྱུར་བ_ཐ་མི་དད་པ
དགོག | འགོག_མ་འོངས་པ།_འབྲི་ཚུལ
དགོངས | གཟུགས་མི་འགྱུར་བ_ཐ་དད་པ
དགོད | དགོད_སྐུལ་ཚིག_ཐ་དད་པ+དགོད_ད་ལྟ་བ།_ཐ་དད་པ+འགོད_མ་འོངས་པ།_ཐ་དད་པ
དགོལ | འཁོལ_མ་འོངས་པ།_ཐ་དད་པ
དགྱེ | གཟུགས་མི་འགྱུར་བ_ཐ་མི་དད་པ
དགྱེད | འགྱེད_མ་འོངས་པ།_འབྲི་ཚུལ
དགྱེལ | བྱ་ཚིག_ཐ་དད་པ
དགྱེས | གཟུགས་མི་འགྱུར་བ_ཐ་མི་དད་པ
དགྲམ | ཁྲོམ_མ་འོངས་པ།_ཐ་དད་པ+འགྲེམ_མ་འོངས་པ།_ཐ་དད་པ
དགྲོང | དགྲོང_ད་ལྟ་བ།_ཐ་དད་པ
དགྲོངས | དགྲོང_སྐུལ་ཚིག_ཐ་དད་པ
དགྲོལ | འགྲེལ_མ་འོངས་པ།_ཐ་དད་པ+འགྲོལ_མ་འོངས་པ།_ཐ་དད་པ
དངང | དངང_མ་འོངས་པ།_ཐ་མི་དད་པ+དངང_ད་ལྟ་བ།_ཐ་མི་དད་པ
དངངས | དངང_འདས་པ།_ཐ་མི་དད་པ
དངར | གཟུགས་མི་འགྱུར་བ_ཐ་མི་དད་པ
དད | གཟུགས་མི་འགྱུར་བ_ཐ་མི་དད་པ
དཔག | དཔོག_མ་འོངས་པ།_ཐ་དད་པ+དཔགས_མ་འོངས་པ།_ཐ་དད་པ
དཔགས | དཔགས_འདས་པ།_ཐ་དད་པ+དཔོག_འདས་པ།_ཐ་དད་པ
དཔར | དཔར_འདས་པ།_ཐ་དད་པ+དཔར_མ་འོངས་པ།_ཐ་དད་པ+དཔར_ད་ལྟ་བ།_ཐ་དད་པ
དཔུར | གཟུགས་མི་འགྱུར་བ_ཐ་མི་དད་པ
དཔོག | དཔོག_ད་ལྟ་བ།_ཐ་དད་པ+དཔགས_ད་ལྟ་བ།_ཐ་དད་པ
དཔོགས | དཔོག_སྐུལ་ཚིག_ཐ་དད་པ+དཔགས_སྐུལ་ཚིག_ཐ་དད་པ
དཔོད | བྱ་ཚིག_###+གཟུགས་མི་འགྱུར་བ_ཐ་དད་པ
དཔོར | དཔར_སྐུལ་ཚིག_ཐ་དད་པ
དཔྱ | དཔྱ_ད་ལྟ་བ།_ཐ་དད་པ+དཔྱ_མ་འོངས་པ།_ཐ་དད་པ
དཔྱང | དཔྱོང_མ་འོངས་པ།_ཐ་དད་པ
དཔྱངས | དཔྱོང_འདས་པ།_ཐ་དད་པ
དཔྱད | དཔྱད_འདས་པ།_ཐ་དད་པ+དཔྱད_མ་འོངས་པ།_ཐ་དད་པ+དཔྱོད_འདས་པ།_ཐ་དད་པ+དཔྱོད_མ་འོངས་པ།_ཐ་དད་པ
དཔྱས | དཔྱ_འདས་པ།_ཐ་དད་པ
དཔྱོང | དཔྱོང_ད་ལྟ་བ།_ཐ་དད་པ
དཔྱོངས | དཔྱོང_སྐུལ་ཚིག_ཐ་དད་པ
དཔྱོད | དཔྱད_ད་ལྟ་བ།_ཐ་དད་པ+དཔྱོད_སྐུལ་ཚིག_ཐ་དད་པ+དཔྱོད_ད་ལྟ་བ།_ཐ་དད་པ+དཔྱད_སྐུལ་ཚིག_ཐ་དད་པ
དཔྱོས | དཔྱ_སྐུལ་ཚིག_ཐ་དད་པ
དཔྲུལ | བྱ་ཚིག_###+གཟུགས་མི་འགྱུར་བ_ཐ་དད་པ
དཔྲེ | དཔྲེ_མ་འོངས་པ།_###+དཔྲེ_ད་ལྟ་བ།_###+དཔྲེས_ད་ལྟ་བ།_###+དཔྲེས_མ་འོངས་པ།_###
དཔྲེས | དཔྲེ_འདས་པ།_###+དཔྲེས_འདས་པ།_###+དཔྲེ_སྐུལ་ཚིག_###+དཔྲེས_སྐུལ་ཚིག_###
དབག | དབག_ད་ལྟ་བ།_ཐ་མི་དད་པ+དབག_མ་འོངས་པ།_ཐ་མི་དད་པ
དབགས | དབག_འདས་པ།_ཐ་མི་དད་པ
དབབ | འབེབས_མ་འོངས་པ།_ཐ་དད་པ+འབེབས_མ་འོངས་པ།_###
དབུག | འབིག_མ་འོངས་པ།_ཐ་དད་པ
དབུབ | འབུབས_མ་འོངས་པ།_ཐ་དད་པ+ཕུབ_མ་འོངས་པ།_ཐ་དད་པ+འབུབས_མ་འོངས་པ།_###
དབུར | གཟུགས་མི་འགྱུར་བ_ཐ་དད་པ
དབུལ | ཕུལ_མ་འོངས་པ།_ཐ་དད་པ+གཟུགས་མི་འགྱུར་བ_ཐ་མི་དད་པ+འབུལ_མ་འོངས་པ།_ཐ་དད་པ
དབེན | གཟུགས་མི་འགྱུར་བ_ཐ་མི་དད་པ
དབོ | འབོ_མ་འོངས་པ།_ཐ་དད་པ
དབོག | འབོགས_མ་འོངས་པ།_ཐ་དད་པ+འབོགས_མ་འོངས་པ།_###
དབོར | གཟུགས་མི་འགྱུར་བ_ཐ་དད་པ
དབོས | གཟུགས་མི་འགྱུར་བ_ཐ་མི་དད་པ
དབྱི | འབྱིད_མ་འོངས་པ།_###+འབྱིད_མ་འོངས་པ།_ཐ་དད་པ
དབྱིས | གཟུགས་མི་འགྱུར་བ_ཐ་དད་པ
དབྱུག | དབྱུག_མ་འོངས་པ།_ཐ་དད་པ+དབྱུག_ད་ལྟ་བ།_ཐ་དད་པ+དབྱུགས_ད་ལྟ་བ།_ཐ་དད་པ+དབྱུགས_མ་འོངས་པ།_ཐ་དད་པ
དབྱུགས | དབྱུག_སྐུལ་ཚིག_ཐ་དད་པ+དབྱུགས_འདས་པ།_ཐ་དད་པ+དབྱུག_འདས་པ།_ཐ་དད་པ+དབྱུགས_སྐུལ་ཚིག_ཐ་དད་པ
དབྱུང | འབྱིན_མ་འོངས་པ།_ཐ་དད་པ+འབྱིན_མ་འོངས་པ།_###
དབྱུལ | བྱ་ཚིག_ཐ་མི་དད་པ
དབྱེ | འབྱེད_མ་འོངས་པ།_ཐ་དད་པ+འབྱེད_མ་འོངས་པ།_###
དབྲད | འབྲད_མ་འོངས་པ།_ཐ་དད་པ+འབྲད_མ་འོངས་པ།_###
དབྲབ | འབྲབ_མ་འོངས་པ།_འབྲི་ཚུལ
དབྲལ | དབྲལ_མ་འོངས་པ།_###+དབྲོལ_འདས་པ།_ཐ་དད་པ+འབྲལ_མ་འོངས་པ།_ཐ་དད་པ+དབྲལ_འདས་པ།_###+དབྲོལ_མ་འོངས་པ།_ཐ་དད་པ
དབྲི | འཕྲི_མ་འོངས་པ།_ཐ་དད་པ
དབྲོག | དབྲོག_མ་འོངས་པ།_ཐ་དད་པ
དབྲོལ | དབྲལ_སྐུལ་ཚིག_###+དབྲལ_ད་ལྟ་བ།_###+དབྲོལ_སྐུལ་ཚིག_ཐ་དད་པ+དབྲོལ_ད་ལྟ་བ།_ཐ་དད་པ
དམད | དམད_མ་འོངས་པ།_ཐ་དད་པ+དམོད_མ་འོངས་པ།_###+དམད_འདས་པ།_ཐ་དད་པ+དམོད_འདས་པ།_###
དམའ | དམའ_མ་འོངས་པ།_ཐ་དད་པ+དམའ_ད་ལྟ་བ།_ཐ་དད་པ
དམར | དམར_ད་ལྟ་བ།_ཐ་དད་པ+དམར_མ་འོངས་པ།_ཐ་དད་པ+དམར_འདས་པ།_ཐ་དད་པ
དམས | དམའ_འདས་པ།_ཐ་དད་པ
དམིགས | གཟུགས་མི་འགྱུར་བ_ཐ་མི་དད་པ
དམུར | གཟུགས་མི་འགྱུར་བ_ཐ་དད་པ
དམུལ | གཟུགས་མི་འགྱུར་བ_ཐ་མི་དད་པ
དམུས | གཟུགས་མི་འགྱུར་བ_ཐ་མི་དད་པ
དམེ | དམེ_ད་ལྟ་བ།_ཐ་མི་དད་པ+དམེ_མ་འོངས་པ།_ཐ་མི་དད་པ
དམེས | དམེ_འདས་པ།_ཐ་མི་དད་པ+དམེ_སྐུལ་ཚིག_ཐ་མི་དད་པ
དམོད | དམད_སྐུལ་ཚིག_ཐ་དད་པ+དམད_ད་ལྟ་བ།_ཐ་དད་པ+དམོད_ད་ལྟ་བ།_###+གཟུགས་མི་འགྱུར་བ_ཐ་དད་པ+དམོད_སྐུལ་ཚིག_###
དམོན | བྱ་ཚིག_ཐ་དད་པ+རྨོ_འབྲི་ཚུལ
དམོར | དམར_སྐུལ་ཚིག_ཐ་དད་པ
དམྱལ | བྱ་ཚིག_###+གཟུགས་མི་འགྱུར་བ_ཐ་དད་པ
དམྱུག | དམྱུག_ད་ལྟ་བ།_ཐ་མི་དད་པ+དམྱུགས_ད་ལྟ་བ།_ཐ་མི་དད་པ+དམྱུག_མ་འོངས་པ།_###+དམྱུགས_ད་ལྟ་བ།_ཐ་དད་པ+དམྱུག_ད་ལྟ་བ།_###+དམྱུག_མ་འོངས་པ།_ཐ་དད་པ+དམྱུག_མ་འོངས་པ།_ཐ་མི་དད་པ+དམྱུགས_མ་འོངས་པ།_ཐ་མི་དད་པ+དམྱུགས_མ་འོངས་པ།_ཐ་དད་པ+དམྱུག_ད་ལྟ་བ།_ཐ་དད་པ
དམྱུགས | དམྱུགས_སྐུལ་ཚིག_ཐ་མི་དད་པ+དམྱུགས_འདས་པ།_ཐ་མི་དད་པ+དམྱུགས_འདས་པ།_ཐ་དད་པ+དམྱུག_སྐུལ་ཚིག_ཐ་མི་དད་པ+དམྱུག_འདས་པ།_ཐ་དད་པ+དམྱུག_སྐུལ་ཚིག_###+དམྱུག_སྐུལ་ཚིག_ཐ་དད་པ+དམྱུགས_སྐུལ་ཚིག_ཐ་དད་པ+དམྱུག_འདས་པ།_###+དམྱུག_འདས་པ།_ཐ་མི་དད་པ
དར | གཟུགས་མི་འགྱུར་བ_ཐ་མི་དད་པ
དུགས | གདུག_སྐུལ་ཚིག_ཐ་དད་པ
དུང | དུང_ད་ལྟ་བ།_ཐ་མི་དད་པ+བྱ་ཚིག_###+དུང_མ་འོངས་པ།_ཐ་མི་དད་པ
དུངས | དུང_འདས་པ།_ཐ་མི་དད་པ
དུད | གཟུགས་མི་འགྱུར་བ_ཐ་མི་དད་པ
དུབ | གཟུགས་མི་འགྱུར་བ_ཐ་མི་དད་པ
དུམ | དུམ_ད་ལྟ་བ།_ཐ་དད་པ+དུམ_མ་འོངས་པ།_ཐ་དད་པ+དུམ_འདས་པ།_ཐ་དད་པ
དེངས | དེངས_སྐུལ་ཚིག_ཐ་མི་དད་པ+དེངས_འདས་པ།_ཐ་མི་དད་པ+འདོང_སྐུལ་ཚིག_ཐ་མི་དད་པ+གཟུགས་མི་འགྱུར་བ_###+འདོང_འདས་པ།_ཐ་མི་དད་པ
དེད | འདེད_འདས་པ།_###+དེད_སྐུལ་ཚིག_###+འདེད_སྐུལ་ཚིག_###+འདེད_འདས་པ།_ཐ་དད་པ+དེད_འདས་པ།_###+འདེད_སྐུལ་ཚིག_ཐ་དད་པ
དོགས | གཟུགས་མི་འགྱུར་བ_ཐ་མི་དད་པ
དོང | བྱ་ཚིག_ཐ་མི་དད་པ
དོངས | འདོང_སྐུལཚིག_འབྲི་ཚུལ
དོད | གཟུགས་མི་འགྱུར་བ_ཐ་མི་དད་པ+བཏོད_སྐུལཚིག_འབྲི་ཚུལ
དོར | དོར_འདས་པ།_ཐ་དད་པ+དོར_མ་འོངས་པ།_ཐ་དད་པ+འདོར_སྐུལ་ཚིག_ཐ་དད་པ+འདོར_མ་འོངས་པ།_ཐ་དད་པ+དོར_སྐུལ་ཚིག_ཐ་དད་པ+འདོར_འདས་པ།_ཐ་དད་པ
དྭངས | གཟུགས་མི་འགྱུར་བ_ཐ་མི་དད་པ
དྲ | འདྲ_མ་འོངས་པ།_ཐ་དད་པ
དྲག | གཟུགས་མི་འགྱུར་བ_ཐ་མི་དད་པ
དྲང | འདྲེན_མ་འོངས་པ།_ཐ་དད་པ+འདྲེན_མ་འོངས་པ།_###
དྲངས | འདྲེན_འདས་པ།_###+འདྲེན_འདས་པ།_ཐ་དད་པ
དྲན | དྲན_འདས་པ།_###+དྲན_ད་ལྟ་བ།_###+དྲན_མ་འོངས་པ།_ཐ་དད་པ+དྲན_མ་འོངས་པ།_###+དྲན_ད་ལྟ་བ།_ཐ་དད་པ+དྲན_འདས་པ།_ཐ་དད་པ
དྲལ | དྲལ_མ་འོངས་པ།_ཐ་མི་དད་པ+འདྲལ_འདས་པ།_ཐ་མི་དད་པ+དྲལ_འདས་པ།_ཐ་མི་དད་པ+འདྲལ_མ་འོངས་པ།_ཐ་མི་དད་པ
དྲས | འདྲ_འདས་པ།_ཐ་དད་པ
དྲི | འདྲི_མ་འོངས་པ།_ཐ་དད་པ+དྲིས_མ་འོངས་པ།_ཐ་དད་པ
དྲིལ | དྲིལ_སྐུལ་ཚིག_ཐ་དད་པ+འདྲིལ_མ་འོངས་པ།_ཐ་དད་པ+འདྲིལ_འདས་པ།_ཐ་དད་པ+འདྲིལ_སྐུལ་ཚིག_ཐ་དད་པ+འདྲིལ_སྐུལ་ཚིག_###+འདྲིལ_མ་འོངས་པ།_###+འདྲིལ_འདས་པ།_###+དྲིལ_འདས་པ།_ཐ་དད་པ+དྲིལ_མ་འོངས་པ།_ཐ་དད་པ
དྲིས | འདྲི_སྐུལ་ཚིག_ཐ་དད་པ+དྲིས_འདས་པ།_ཐ་དད་པ+འདྲི_འདས་པ།_ཐ་དད་པ+དྲིས_སྐུལ་ཚིག_ཐ་དད་པ
དྲུད | འདྲུད_འདས་པ།_ཐ་དད་པ+འདྲུད_འདས་པ།_ཐ་མི་དད་པ+དྲུད_སྐུལ་ཚིག_ཐ་མི་དད་པ+དྲུད_འདས་པ།_ཐ་མི་དད་པ+འདྲུད_སྐུལ་ཚིག_ཐ་དད་པ+འདྲུད_སྐུལ་ཚིག_ཐ་མི་དད་པ
དྲུབ | དྲུབས_མ་འོངས་པ།_ཐ་དད་པ
དྲུབས | དྲུབས_སྐུལ་ཚིག_ཐ་དད་པ+དྲུབས_སྐུལ་ཚིག_ཐ་མི་དད་པ+འདྲུབ_འདས་པ།_ཐ་མི་དད་པ+དྲུབས_འདས་པ།_ཐ་མི་དད་པ+འདྲུབ_འདས་པ།_ཐ་དད་པ+དྲུབས_འདས་པ།_ཐ་དད་པ+འདྲུབ_སྐུལ་ཚིག_ཐ་དད་པ
དྲུམས | གྲུམས_འབྲི་ཚུལ+བྱ་ཚིག_###
དྲུལ | དྲུལ_སྐུལ་ཚིག_ཐ་དད་པ+འདྲུལ_འདས་པ།_ཐ་དད་པ+འདྲུལ_སྐུལ་ཚིག_ཐ་དད་པ+འདྲུལ_འདས་པ།_ཐ་མི་དད་པ+དྲུལ_འདས་པ།_ཐ་དད་པ
དྲུས | འདྲུ_སྐུལ་ཚིག_ཐ་དད་པ+དྲུས_སྐུལ་ཚིག_ཐ་དད་པ+འདྲུ_འདས་པ།_ཐ་དད་པ+དྲུས_འདས་པ།_ཐ་དད་པ
དྲེད | གཟུགས་མི་འགྱུར་བ_ཐ་མི་དད་པ
དྲོ | དྲོ_ད་ལྟ་བ།_ཐ་མི་དད་པ+དྲོ_མ་འོངས་པ།_ཐ་མི་དད་པ
དྲོངས | འདྲེན_སྐུལ་ཚིག_###+འདྲེན_སྐུལ་ཚིག_ཐ་དད་པ
དྲོན | དྲན_སྐུལ་ཚིག_###+དྲན_སྐུལ་ཚིག_ཐ་དད་པ
དྲོལ | དྲལ_སྐུལ་ཚིག_ཐ་མི་དད་པ
དྲོས | དྲོ_འདས་པ།_ཐ་མི་དད་པ+འདྲ_སྐུལ་ཚིག_ཐ་དད་པ
ན | གཟུགས་མི་འགྱུར་བ_ཐ་མི་དད་པ
ནབ | ནབ_ད་ལྟ་བ།_ཐ་དད་པ
ནུ | ནུས_ད་ལྟ་བ།_ཐ་དད་པ+ནུས_མ་འོངས་པ།_ཐ་དད་པ
ནུད | བྱ་ཚིག_###+གཟུགས་མི་འགྱུར་བ_ཐ་དད་པ
ནུབ | བྱ་ཚིག_###+གཟུགས་མི་འགྱུར་བ_ཐ་མི་དད་པ
ནུར | གཟུགས་མི་འགྱུར་བ_ཐ་མི་དད་པ+བྱ་ཚིག_###
ནུས | ནུས_འདས་པ།_ཐ་དད་པ+ནུས_སྐུལ་ཚིག_ཐ་དད་པ
ནོགས | བྱ་ཚིག_###+གཟུགས་མི་འགྱུར་བ_ཐ་དད་པ
ནོངས | གཟུགས་མི་འགྱུར་བ_ཐ་མི་དད་པ+བྱ་ཚིག_###
ནོད | ནོད_ད་ལྟ་བ།_ཐ་དད་པ
ནོན | མནན_སྐུལ་ཚིག_ཐ་དད་པ+གནོན_སྐུལ་ཚིག_ཐ་དད་པ
ནོབས | ནབ_སྐུལ་ཚིག_ཐ་དད་པ
ནོམ | ནོམ_ད་ལྟ་བ།_###+ནོམ_ད་ལྟ་བ།_ཐ་མི་དད་པ+ནོམ_ད་ལྟ་བ།_ཐ་དད་པ
ནོམས | ནོམ_སྐུལ་ཚིག_###+ནོམ_སྐུལ་ཚིག_ཐ་དད་པ+ནོམ_སྐུལ་ཚིག_ཐ་མི་དད་པ
ནོར | གཟུགས་མི་འགྱུར་བ_ཐ་མི་དད་པ
ནོལ | གཟུགས་མི་འགྱུར་བ_ཐ་མི་དད་པ+མནོལ_འབྲི་ཚུལ+བྱ་ཚིག_###
ནོས | མནོས_འབྲི་ཚུལ+བྱ་ཚིག_###+གནོས_འབྲི་ཚུལ+བྱ་ཚིག_ཐ་དད་པ
ཕངས | བྱ་ཚིག_###+བྱ་ཚིག_ཐ་མི་དད་པ
ཕན | གཟུགས་མི་འགྱུར་བ_ཐ་དད་པ
ཕབ | འབེབས_འདས་པ།_ཐ་དད་པ+འབེབས_འདས་པ།_###
ཕམ | འཕམ_འདས་པ།_ཐ་མི་དད་པ
ཕིག | འབིག_འདས་པ།_འབྲི་ཚུལ
ཕིགས | འབིག_སྐུལ་ཚིག_ཐ་དད་པ
ཕུག | འབིག_འདས་པ།_ཐ་དད་པ+ཕིག_འབྲི་ཚུལ+བྱ་ཚིག_ཐ་དད་པ
ཕུགས | འབིག_སྐུལཚིག_འབྲི་ཚུལ
ཕུང | འཕུང_འདས་པ།_ཐ་དད་པ+ཕུང_འདས་པ།_ཐ་དད་པ
ཕུད | འཕུད_སྐུལ་ཚིག_ཐ་དད་པ+ཕུད_འདས་པ།_ཐ་དད་པ+འཕུད_སྐུལ་ཚིག_###+འཕུད_འདས་པ།_###+འཕུད_འདས་པ།_ཐ་དད་པ+ཕུད_སྐུལ་ཚིག_ཐ་དད་པ
ཕུབ | འབུབས_འདས་པ།_ཐ་དད་པ+འབུབས_འདས་པ།_###+ཕུབ_འདས་པ།_ཐ་དད་པ
ཕུབས | ཕུབ_སྐུལ་ཚིག_ཐ་དད་པ+འབུབས_སྐུལ་ཚིག_ཐ་དད་པ+འབུབས_སྐུལ་ཚིག_###
ཕུར | ཕུར_འདས་པ།_ཐ་མི་དད་པ+འཕུར_སྐུལ་ཚིག_ཐ་མི་དད་པ+འཕུར_འདས་པ།_ཐ་མི་དད་པ+ཕུར_སྐུལ་ཚིག_ཐ་མི་དད་པ+འཕུར_སྐུལ་ཚིག_###+འཕུར_འདས་པ།_###
ཕུལ | ཕུལ_འདས་པ།_ཐ་དད་པ+འབུལ_འདས་པ།_ཐ་དད་པ+ཕུལ_སྐུལ་ཚིག_ཐ་དད་པ
ཕེབས | གཟུགས་མི་འགྱུར་བ_ཐ་མི་དད་པ
ཕོ | འབོ_འདས་པ།_ཐ་དད་པ
ཕོག | འཕོག_འདས་པ།_###+འཕོག_འདས་པ།_ཐ་མི་དད་པ+འབོགས_འདས་པ།_###+འབོགས_འདས་པ།_ཐ་དད་པ
ཕོགས | འབོགས_སྐུལ་ཚིག_###+འབོགས_སྐུལ་ཚིག_ཐ་དད་པ
ཕོངས | འཕོངས_འདས་པ།_ཐ་མི་དད་པ
ཕོབ | འབེབས_སྐུལ་ཚིག_ཐ་དད་པ+འབེབས_སྐུལ་ཚིག_###
ཕོས | འབོ_སྐུལ་ཚིག_ཐ་དད་པ
ཕྱག | འཕྱག_མ་འོངས་པ།_ཐ་དད་པ
ཕྱགས | འཕྱག_འདས་པ།_ཐ་དད་པ
ཕྱར | ཕྱར_འདས་པ།_ཐ་དད་པ+འཕྱར_འདས་པ།_###+ཕྱར_མ་འོངས་པ།_ཐ་དད་པ+འཕྱར_འདས་པ།_ཐ་དད་པ+འཕྱར_མ་འོངས་པ།_ཐ་དད་པ
ཕྱི | འབྱིད_འདས་པ།_ཐ་དད་པ+འབྱིད_འདས་པ།_###
ཕྱིད | འཕྱིད_འདས་པ།_ཐ་མི་དད་པ+འཕྱིད_འདས་པ།_###
ཕྱིན | གཟུགས་མི་འགྱུར་བ_ཐ་མི་དད་པ
ཕྱིས | གཟུགས་མི་འགྱུར་བ_ཐ་མི་དད་པ+འབྱིད_སྐུལ་ཚིག_###+འབྱིད_སྐུལ་ཚིག_ཐ་དད་པ
ཕྱུག | གཟུགས་མི་འགྱུར་བ_ཐ་མི་དད་པ
ཕྱུང | འབྱིན_འདས་པ།_ཐ་དད་པ+འབྱིན_འདས་པ།_###
ཕྱུངས | འབྱིན_སྐུལ་ཚིག_###+འབྱིན_སྐུལ་ཚིག_ཐ་དད་པ
ཕྱེ | འབྱེད_འདས་པ།_ཐ་དད་པ+འབྱེད_འདས་པ།_###
ཕྱེད | གཟུགས་མི་འགྱུར་བ_ཐ་མི་དད་པ+བྱ་ཚིག_###
ཕྱེས | འབྱེད_སྐུལ་ཚིག_###+འབྱེད_སྐུལ་ཚིག_ཐ་དད་པ
ཕྱོགས | གཟུགས་མི་འགྱུར་བ_ཐ་མི་དད་པ+འཕྱག_སྐུལ་ཚིག_ཐ་དད་པ
ཕྱོར | ཕྱར_སྐུལ་ཚིག_ཐ་དད་པ+འཕྱར_སྐུལ་ཚིག_ཐ་དད་པ+འཕྱར_སྐུལ་ཚིག_###
ཕྲད | འཕྲད_འདས་པ།_འབྲི་ཚུལ+འཕྲད_འདས་པ།_ཐ་མི་དད་པ
ཕྲལ | འཕྲལ_འདས་པ།_ཐ་དད་པ+ཕྲལ_མ་འོངས་པ།_ཐ་དད་པ+འབྲལ_འདས་པ།_ཐ་དད་པ+ཕྲལ_འདས་པ།_ཐ་དད་པ+འཕྲལ_མ་འོངས་པ།_ཐ་དད་པ
ཕྲས | བྱ་ཚིག_ཐ་མི་དད་པ+འཕྲ_འདསཔ_འབྲི་ཚུལ
ཕྲི | བྱ་ཚིག_###+འཕྲི_འདས་པ།_ཐ་དད་པ
ཕྲིས | འཕྲི_སྐུལ་ཚིག_ཐ་དད་པ+འབྲིད_སྐུལཚིག_འབྲི་ཚུལ
ཕྲུགས | འཕྲུག_སྐུལཚིག_འབྲི་ཚུལ
ཕྲུལ | འབྲུལ_འདས་པ།_འབྲི་ཚུལ
ཕྲོག | དབྲོག_འདས་པ།_ཐ་དད་པ
ཕྲོགས | ཕྲོགས_སྐུལ་ཚིག_ཐ་དད་པ+འཕྲོག_འདས་པ།_ཐ་དད་པ+ཕྲོགས_འདས་པ།_ཐ་དད་པ+འཕྲོག_སྐུལ་ཚིག_ཐ་དད་པ+དབྲོག_སྐུལ་ཚིག_ཐ་དད་པ
ཕྲོད | འབྲད_སྐུལ་ཚིག_ཐ་དད་པ+འབྲད_སྐུལ་ཚིག_###
ཕྲོབས | འབྲབ_སྐུལཚིག_འབྲི་ཚུལ
ཕྲོལ | ཕྲལ_སྐུལ་ཚིག_ཐ་དད་པ+འབྲལ_སྐུལ་ཚིག_ཐ་དད་པ+འཕྲལ_སྐུལ་ཚིག_ཐ་དད་པ
ཕྲོས | འབྲོས_སྐུལ་ཚིག_འབྲི་ཚུལ
བཀག | འགོག_འདས་པ།_ཐ་དད་པ+འགོག_འདས་པ།_###
བཀང | འགེངས_འདས་པ།_ཐ་དད་པ
བཀད | འགད_འདས་པ།_###+འགད_འདས་པ།_ཐ་དད་པ
བཀན | བཀན_འདས་པ།_ཐ་མི་དད་པ+བཀན_ད་ལྟ་བ།_ཐ་མི་དད་པ+བཀན_མ་འོངས་པ།_ཐ་མི་དད་པ
བཀབ | འགེབ_འདས་པ།_ཐ་དད་པ+འགེབ_འདས་པ།_###
བཀར | དགར_འདས་པ།_###+འགེར_འདས་པ།_ཐ་དད་པ+འགེར_འདས་པ།_###
བཀལ | འཁེལ_མའོངསཔ_འབྲི་ཚུལ+འཁེལ_འདས་པ།_ཐ་དད་པ+འཁེལ_མ་འོངས་པ།_ཐ་དད་པ+འཁེལ_འདསཔ_འབྲི་ཚུལ+བྱ་ཚིག_ཐ་མི་དད་པ+འགེལ_འདས་པ།_###
བཀས | འགས_འདས་པ།_ཐ་དད་པ
བཀུ | བཀུ_མ་འོངས་པ།_ཐ་དད་པ+བཀུ_ད་ལྟ་བ།_ཐ་དད་པ+བཀུས_ད་ལྟ་བ།_ཐ་དད་པ+བཀུས_མ་འོངས་པ།_ཐ་དད་པ
བཀུག | འགུགས_འདས་པ།_ཐ་དད་པ+འགུགས_འདས་པ།_###
བཀུམ | འགུམ_འདས་པ།_ཐ་དད་པ
བཀུར | བྱ་ཚིག_ཐ་དད་པ
བཀུས | བཀུ_འདས་པ།_ཐ་དད་པ+བཀུ_སྐུལ་ཚིག_ཐ་དད་པ+བཀུས_འདས་པ།_ཐ་དད་པ+བཀུས_སྐུལ་ཚིག_ཐ་དད་པ
བཀོག | འགོག_འདས་པ།_འབྲི་ཚུལ
བཀོང | བཀོངས_མ་འོངས་པ།_ཐ་དད་པ+བཀོང_མ་འོངས་པ།_ཐ་མི་དད་པ+བཀོང_ད་ལྟ་བ།_ཐ་མི་དད་པ+བཀོང_ད་ལྟ་བ།_ཐ་དད་པ+བཀོངས_མ་འོངས་པ།_ཐ་མི་དད་པ+བཀོངས_ད་ལྟ་བ།_ཐ་དད་པ+བཀོང_མ་འོངས་པ།_ཐ་དད་པ+བཀོངས_ད་ལྟ་བ།_ཐ་མི་དད་པ
བཀོངས | བཀོང_འདས་པ།_ཐ་མི་དད་པ+བཀོང_སྐུལ་ཚིག_ཐ་མི་དད་པ+བཀོང_འདས་པ།_ཐ་དད་པ+བཀོང_སྐུལ་ཚིག_ཐ་དད་པ+བཀོངས_སྐུལ་ཚིག_ཐ་མི་དད་པ+བཀོངས_འདས་པ།_ཐ་དད་པ+བཀོངས_འདས་པ།_ཐ་མི་དད་པ+བཀོངས_སྐུལ་ཚིག_ཐ་དད་པ
བཀོད | འགོད_འདས་པ།_ཐ་དད་པ
བཀོན | འཁོན_མ་འོངས་པ།_ཐ་དད་པ+འཁོན_འདས་པ།_ཐ་མི་དད་པ+གཟུགས་མི་འགྱུར་བ_ཐ་དད་པ+བཀོན_མ་འོངས་པ།_ཐ་མི་དད་པ+བཀོན_འདས་པ།_ཐ་མི་དད་པ+འཁོན_འདས་པ།_ཐ་དད་པ+འཁོན_མ་འོངས་པ།_ཐ་མི་དད་པ+བཀན_སྐུལ་ཚིག_ཐ་མི་དད་པ
བཀོལ | འཁོལ_མ་འོངས་པ།_###+འཁོལ_འདས་པ།_###+འཁོལ_འདས་པ།_ཐ་དད་པ
བཀྱག | འགྱོག_མ་འོངས་པ།_ཐ་དད་པ+ཁྱོག_མ་འོངས་པ།_ཐ་དད་པ
བཀྱགས | འགྱོག_འདས་པ།_ཐ་དད་པ+ཁྱོག_འདས་པ།_ཐ་དད་པ
བཀྱལ | འཁྱལ_འདས་པ།_ཐ་མི་དད་པ+འཁྱལ_མ་འོངས་པ།_ཐ་མི་དད་པ+བཀྱལ_མ་འོངས་པ།_ཐ་མི་དད་པ+བཀྱལ_འདས་པ།_ཐ་མི་དད་པ
བཀྱིག | འཁྱིག_མ་འོངས་པ།_ཐ་དད་པ
བཀྱིགས | འཁྱིག_འདས་པ།_ཐ་དད་པ
བཀྱེ | འགྱེད_མ་འོངས་པ།_ཐ་དད་པ+འགྱེད_མ་འོངས་པ།_###
བཀྱེད | འགྱེད_འདས་པ།_###
བཀྱེས | འགྱེད_འདས་པ།_ཐ་དད་པ+འགྱེད_འདས་པ།_###
བཀྱོན | གཟུགས་མི་འགྱུར་བ_ཐ་དད་པ
བཀྲབ | འཁྲབ_འདས་པ།_ཐ་དད་པ
བཀྲབས | བྱ་ཚིག_ཐ་དད་པ
བཀྲམ | ཁྲོམ_འདས་པ།_ཐ་དད་པ+འགྲེམ_འདས་པ།_ཐ་དད་པ
བཀྲལ | འགྲེལ_འདས་པ།_ཐ་དད་པ
བཀྲི | འཁྲིད_མ་འོངས་པ།_###
བཀྲིས | འཁྲིད_འདས་པ།_###
བཀྲུ | འཁྲུད_མ་འོངས་པ།_ཐ་དད་པ
བཀྲུམས | དཀྲུམ_སྐུལཚིག_འབྲི་ཚུལ+དཀྲུམ_འདསཔ_འབྲི་ཚུལ
བཀྲུས | འཁྲུད_འདས་པ།_ཐ་དད་པ
བཀྲེས | གཟུགས་མི་འགྱུར་བ_ཐ་མི་དད་པ
བཀྲོངས | དགྲོང_འདས་པ།_ཐ་དད་པ
བཀྲོབས | འཁྲབ_སྐུལཚིག_འབྲི་ཚུལ
བཀྲོལ | འཁྲོལ_མ་འོངས་པ།_ཐ་དད་པ+འགྲོལ_འདས་པ།_ཐ་དད་པ+འཁྲོལ_འདས་པ།_###+འཁྲོལ_འདས་པ།_ཐ་དད་པ
བཀླག | ཀློག_མ་འོངས་པ།_ཐ་དད་པ
བཀླགས | ཀློག_འདས་པ།_ཐ་དད་པ
བཀླུབ | ཀླུབ_མ་འོངས་པ།_ཐ་དད་པ
བཀླུབས | ཀླུབ_འདས་པ།_ཐ་དད་པ
བགག | བསྒག_འབྲི་ཚུལ+བྱ་ཚིག_ཐ་དད་པ
བགགས | བསྒགས_འབྲི་ཚུལ+བྱ་ཚིག_###+འགེགས_འདསཔ_འབྲི་ཚུལ+བྱ་ཚིག_ཐ་དད་པ
བགད | དགོད_འདས་པ།_ཐ་དད་པ+དགོད_མ་འོངས་པ།_ཐ་དད་པ
བགམ | བགམ_མ་འོངས་པ།_ཐ་དད་པ+བགམ_ད་ལྟ་བ།_ཐ་དད་པ
བགམས | བགམ_འདས་པ།_ཐ་དད་པ
བགོ | བགོས_མ་འོངས་པ།_ཐ་དད་པ+བགོས_ད་ལྟ་བ།_###+བགོ_མ་འོངས་པ།_ཐ་དད་པ+བགོ_ད་ལྟ་བ།_ཐ་དད་པ+བགོད_མ་འོངས་པ།_ཐ་དད་པ+བགོས_མ་འོངས་པ།_###
བགོགས | བསྒགས_སྐུལཚིག_འབྲི་ཚུལ
བགོད | བགོད_ད་ལྟ་བ།_ཐ་དད་པ+བགོད_སྐུལ་ཚིག_ཐ་དད་པ+བགོས_སྐུལ་ཚིག_ཐ་དད་པ+བགོས_ད་ལྟ་བ།_ཐ་དད་པ
བགོམ | འགོམ_མ་འོངས་པ།_ཐ་དད་པ
བགོམས | བགམ_སྐུལ་ཚིག_ཐ་དད་པ+འགོམ_འདས་པ།_ཐ་དད་པ
བགོར | འགོར_མ་འོངས་པ།_ཐ་དད་པ+འགོར_སྐུལ་ཚིག_ཐ་དད་པ+འགོར_འདས་པ།_ཐ་དད་པ+བགོར_མ་འོངས་པ།_ཐ་དད་པ+བགོར_འདས་པ།_ཐ་དད་པ+བགོར_སྐུལ་ཚིག_ཐ་དད་པ
བགོས | བགོ_འདས་པ།_ཐ་དད་པ+བགོས_འདས་པ།_ཐ་དད་པ+བགོས_སྐུལ་ཚིག_###+བགོ_སྐུལ་ཚིག_ཐ་དད་པ+བགོས_འདས་པ།_###+བགོད_འདས་པ།_ཐ་དད་པ
བགྱང | བགྱོངས_མ་འོངས་པ།_ཐ་དད་པ+བགྱང_མ་འོངས་པ།_ཐ་དད་པ+བགྱོངས_ད་ལྟ་བ།_ཐ་དད་པ+བགྱང_ད་ལྟ་བ།_ཐ་དད་པ
བགྱངས | བགྱང_འདས་པ།_ཐ་དད་པ+བགྱོངས_འདས་པ།_ཐ་དད་པ
བགྱི | བགྱིད_མ་འོངས་པ།_ཐ་དད་པ
བགྱིད | བགྱིད_ད་ལྟ་བ།_ཐ་དད་པ
བགྱིས | བགྱིད_འདས་པ།_ཐ་དད་པ
བགྱོངས | བགྱོངས_སྐུལ་ཚིག_ཐ་དད་པ+བགྱང_སྐུལ་ཚིག_ཐ་དད་པ
བགྲང | བགྲང_མ་འོངས་པ།_ཐ་དད་པ+བགྲང_ད་ལྟ་བ།_ཐ་དད་པ
བགྲངས | བགྲང_འདས་པ།_ཐ་དད་པ
བགྲད | བགྲད_ད་ལྟ་བ།_###+བགྲད_འདས་པ།_###+བགྲད_མ་འོངས་པ།_###+བགྲད_འདས་པ།_ཐ་མི་དད་པ+བགྲད_ད་ལྟ་བ།_ཐ་མི་དད་པ+བགྲད_མ་འོངས་པ།_ཐ་མི་དད་པ
བགྲིལ | གཟུགས་མི་འགྱུར་བ_ཐ་དད་པ
བགྲུ | བགྲུས_མ་འོངས་པ།_ཐ་དད་པ+བགྲུད_མ་འོངས་པ།_ཐ་དད་པ
བགྲུང | བགྲུང_མ་འོངས་པ།_ཐ་དད་པ+བགྲུངས_ད་ལྟ་བ།_ཐ་དད་པ+བགྲུངས_མ་འོངས་པ།_ཐ་དད་པ+བགྲུང_ད་ལྟ་བ།_ཐ་དད་པ
བགྲུངས | བགྲུང_སྐུལ་ཚིག_ཐ་དད་པ+བགྲུངས_སྐུལ་ཚིག_ཐ་དད་པ+བགྲུངས_འདས་པ།_ཐ་དད་པ+བགྲུང_འདས་པ།_ཐ་དད་པ
བགྲུད | བགྲུས_ད་ལྟ་བ།_ཐ་དད་པ+བགྲུད_ད་ལྟ་བ།_ཐ་དད་པ
བགྲུས | བགྲུས_འདས་པ།_ཐ་དད་པ+བགྲུད_སྐུལ་ཚིག_ཐ་དད་པ+བགྲུད_འདས་པ།_ཐ་དད་པ+བགྲུས_སྐུལ་ཚིག_ཐ་དད་པ
བགྲེས | གཟུགས་མི་འགྱུར་བ_ཐ་དད་པ
བགྲོ | བགྲོ_མ་འོངས་པ།_ཐ་དད་པ+བགྲོ_ད་ལྟ་བ།_ཐ་དད་པ+བགྲོས_ད་ལྟ་བ།_ཐ་དད་པ+བགྲོས_མ་འོངས་པ།_ཐ་དད་པ
བགྲོང | དགྲོང_མ་འོངས་པ།_ཐ་དད་པ
བགྲོངས | བགྲང_སྐུལ་ཚིག_ཐ་དད་པ
བགྲོད | བགྲད_སྐུལ་ཚིག_ཐ་མི་དད་པ+བྱ་ཚིག_###+གཟུགས་མི་འགྱུར་བ_ཐ་མི་དད་པ+བགྲད_སྐུལ་ཚིག_###
བགྲོས | བགྲོ_སྐུལ་ཚིག_ཐ་དད་པ+བགྲོ_འདས་པ།_ཐ་དད་པ+བགྲོས_འདས་པ།_ཐ་དད་པ+བགྲོས_སྐུལ་ཚིག_ཐ་དད་པ
བང | བང_ད་ལྟ་བ།_འབྲི་ཚུལ+བང_མ་འོངས་པ།_འབྲི་ཚུལ
བངས | བང འདས་པ།_འབྲི་ཚུལ
བཅག | འཇག_འདས་པ།_ཐ་དད་པ+གཅོག_འདས་པ།_###+འཆག_མ་འོངས་པ།_###+གཅོག_འདས་པ།_ཐ་དད་པ
བཅགས | འཆག_འདས་པ།_###
བཅང | བཅང_མ་འོངས་པ།_ཐ་དད་པ+འཆང_མ་འོངས་པ།_###+འཆང_མ་འོངས་པ།_ཐ་དད་པ
བཅངས | བཅང_འདས་པ།_ཐ་དད་པ+འཆང_འདས་པ།_###+འཆང_འདས་པ།_ཐ་དད་པ
བཅད | གཅོད_འདས་པ།_ཐ་དད་པ+གཅོད_འདས་པ།_ཐ་མི་དད་པ+གཅོད_འདས་པ།_###
བཅབ | འཆབ_མ་འོངས་པ།_ཐ་དད་པ
བཅབས | འཆབ_འདས་པ།_ཐ་དད་པ
བཅམས | གཅོམ_འདས་པ།_ཐ་དད་པ
བཅའ | འཆའ_མ་འོངས་པ།_ཐ་དད་པ+བཅའ_མ་འོངས་པ།_ཐ་དད་པ+འཆའ_མ་འོངས་པ།_###+འཆའ_མ་འོངས་པ།_ཐ་མི་དད་པ
བཅར | གཅར_འདས་པ།_ཐ་མི་དད་པ+གཅར_འདས་པ།_###
བཅལ | འཇལ_འདས་པ།_###+འཇལ_འདས་པ།_ཐ་དད་པ
བཅས | འཆའ_འདས་པ།_ཐ་མི་དད་པ+འཆའ_འདས་པ།_ཐ་དད་པ+བཅའ_འདས་པ།_ཐ་དད་པ+འཆའ_འདས་པ།_###
བཅིང | འཆིང_མ་འོངས་པ།_ཐ་དད་པ+བཅིང_མ་འོངས་པ།_ཐ་དད་པ+ཆིངས_མ་འོངས་པ།_ཐ་དད་པ
བཅིངས | ཆིངས_འདས་པ།_ཐ་དད་པ+བཅིང_འདས་པ།_ཐ་དད་པ+འཆིང_འདས་པ།_ཐ་དད་པ
བཅིབ | འཆིབ_མ་འོངས་པ།_ཐ་དད་པ
བཅིབས | འཆིབ_འདས་པ།_ཐ་དད་པ
བཅིར | འཆིར_འདས་པ།_ཐ་དད་པ+འཆིར_འདས་པ།_###
བཅིལ | འཇིལ_འདས་པ།_ཐ་དད་པ
བཅུ | འཆུ_མ་འོངས་པ།_ཐ་དད་པ+འཆུ_མ་འོངས་པ།_###+བཅུས_མ་འོངས་པ།_ཐ་དད་པ
བཅུག | འཇུག_འདས་པ།_ཐ་དད་པ
བཅུན | འཇུན_འདས་པ།_ཐ་དད་པ+འཆུན_འདས་པ།_ཐ་དད་པ
བཅུམ | འཇུམ_མ་འོངས་པ།_ཐ་དད་པ+འཇུམ_མ་འོངས་པ།_ཐ་མི་དད་པ
བཅུམས | འཇུམ_འདས་པ།_ཐ་དད་པ+འཇུམ_འདས་པ།_ཐ་མི་དད་པ
བཅུར | འཇུར_འདས་པ།_ཐ་དད་པ+འཇུར_འདས་པ།_###
བཅུས | བཅུས_འདས་པ།_ཐ་དད་པ+འཆུ_འདས་པ།_ཐ་དད་པ
བཅེམ | ཅེམ_མ་འོངས་པ།_ཐ་དད་པ
བཅེམས | ཅེམ_འདས་པ།_ཐ་དད་པ
བཅེར | ཅེར_མ་འོངས་པ།_###+བཅེར_འདས་པ།_ཐ་དད་པ+ཅེར_འདས་པ།_###+བཅེར_མ་འོངས་པ།_ཐ་དད་པ+ཅེར_འདས་པ།_ཐ་དད་པ+ཅེར_མ་འོངས་པ།_ཐ་དད་པ
བཅོ | འཆོས_མ་འོངས་པ།_འབྲི་ཚུལ
བཅོམ | གཅོམ_མ་འོངས་པ།_ཐ་དད་པ+འཇོམས_འདས་པ།_ཐ་དད་པ
བཅོལ | བཅོལ_མ་འོངས་པ།_ཐ་དད་པ+བཅོལ_འདས་པ།_ཐ་དད་པ+འཆོལ_མ་འོངས་པ།_###+འཆོལ_འདས་པ།_ཐ་དད་པ+འཆོལ_འདས་པ།_###+འཆོལ_མ་འོངས་པ།_ཐ་དད་པ
བཅོས | འཆོས_འདས་པ།_ཐ་དད་པ+ཆོས_འདས་པ།_ཐ་དད་པ+འཆོས_འདས་པ།_###+བཅོས_མ་འོངས་པ།_###+འཆོས_མ་འོངས་པ།_ཐ་དད་པ+འཆོས_མ་འོངས་པ།_###+ཆོས_མ་འོངས་པ།_ཐ་དད་པ+བཅོས_འདས་པ།_###
བཏག | འཐག_མ་འོངས་པ།_ཐ་དད་པ+འདོག_འདས་པ།_ཐ་དད་པ+བཏག_མ་འོངས་པ།_ཐ་དད་པ+འཐག_མ་འོངས་པ།_###
བཏགས | བཏག_འདས་པ།_ཐ་དད་པ+འཐག_འདས་པ།_ཐ་དད་པ+འཐག_འདས་པ།_###+འདོགས_འདས་པ།_###+འདོགས_འདས་པ།_ཐ་དད་པ
བཏང | གཏོང_འདས་པ།_ཐ་དད་པ+གཏོང_འདས་པ།_###
བཏབ | འདེབས_འདས་པ།_###+འདེབས_འདས་པ།_ཐ་དད་པ
བཏམ | འདམ_མ་འོངས་པ།_ཐ་དད་པ
བཏམས | འདམ_འདས་པ།_ཐ་དད་པ
བཏིག | གཏིག_མ་འོངས་པ།_ཐ་དད་པ
བཏིགས | གཏིག_འདས་པ།_ཐ་དད་པ
བཏིངས | འདིང_འདས་པ།_ཐ་དད་པ
བཏུ | བཏུས_མ་འོངས་པ།_ཐ་དད་པ+འཐུ_མ་འོངས་པ།_ཐ་དད་པ
བཏུང | འཐུང_མ་འོངས་པ།_ཐ་དད་པ
བཏུངས | འཐུང_འདས་པ།_ཐ་དད་པ
བཏུད | འདུད_འདས་པ།_ཐ་དད་པ
བཏུབ | གཟུགས་མི་འགྱུར་བ_ཐ་དད་པ
བཏུམ | འཐུམ_འདས་པ།_ཐ་དད་པ+ཐུམ_འདས་པ།_ཐ་དད་པ
བཏུལ | འདུལ_འདས་པ།_ཐ་དད་པ+འདུལ_འདས་པ།_###
བཏུས | བཏུས_འདས་པ།_ཐ་དད་པ+འཐུ_འདས་པ།_ཐ་དད་པ
བཏེག | ཐེག_མ་འོངས་པ།_ཐ་མི་དད་པ+འདེགས_འདས་པ།_ཐ་དད་པ
བཏེགས | ཐེག_འདས་པ།_ཐ་མི་དད་པ
བཏོག | འཐོག_མ་འོངས་པ།_ཐ་དད་པ+འཐོག_མ་འོངས་པ།_###
བཏོགས | འཐོག_འདས་པ།_ཐ་དད་པ+འཐོག_འདས་པ།_###
བཏོད | ཐོད_འདས་པ།_ཐ་དད་པ+གཏོད_འདས་པ།_###+འདོད_འདས་པ།_###
བཏོན | འདོན_འདས་པ།_ཐ་དད་པ+འདོན_འདས་པ།_###
བཏོལ | བྱ་ཚིག_ཐ་དད་པ
བད | གཟུགས་མི་འགྱུར་བ_ཐ་མི་དད་པ+བྱ་ཚིག_###
བདག | བྱ་ཚིག_###
བདམ | བདམ_ད་ལྟ་བ།_###+འདེམ_འདས་པ།_ཐ་དད་པ+བདམ_མ་འོངས་པ།_###
བདམས | བདམ_འདས་པ།_###+བདམ_སྐུལ་ཚིག_###
བདའ | འདེད_མ་འོངས་པ།_###+གཟུགས་མི་འགྱུར་བ_ཐ་དད་པ
བདར | བདར_མ་འོངས་པ།_ཐ་དད་པ+བདར_འདས་པ།_###+བདར_ད་ལྟ་བ།_###+བདར_མ་འོངས་པ།_###+བདར_ད་ལྟ་བ།_ཐ་དད་པ+བདར_འདས་པ།_ཐ་དད་པ
བདལ | བདལ_འདས་པ།_ཐ་དད་པ+བདལ_མ་འོངས་པ།_ཐ་དད་པ+གདལ_མ་འོངས་པ།_###+གདལ_འདས་པ།_ཐ་དད་པ+གདལ_མ་འོངས་པ།_ཐ་དད་པ+གདལ_འདས་པ།_###
བདས | འདེད_འདས་པ།_###
བདུག | གདུག_མ་འོངས་པ།_ཐ་དད་པ
བདུགས | གདུག_འདས་པ།_ཐ་དད་པ
བདུང | བདུང_ད་ལྟ་བ།_ཐ་དད་པ+བདུངས_མ་འོངས་པ།_ཐ་དད་པ+བདུངས_ད་ལྟ་བ།_ཐ་དད་པ+བདུང_མ་འོངས་པ།_ཐ་དད་པ
བདུངས | བདུངས_འདས་པ།_ཐ་དད་པ+བདུང_སྐུལ་ཚིག_ཐ་དད་པ+བདུང_འདས་པ།_ཐ་དད་པ+བདུངས_སྐུལ་ཚིག_ཐ་དད་པ
བདོ | གཟུགས་མི་འགྱུར་བ_ཐ་མི་དད་པ
བདོད | བཏོད_མའོངསཔ_འབྲི་ཚུལ+བྱ་ཚིག_ཐ་དད་པ
བདོར | བདར_སྐུལ་ཚིག_ཐ་དད་པ+བདར_སྐུལ་ཚིག_###
བདོལ | བདལ_སྐུལ་ཚིག_ཐ་དད་པ
བབས | འབབ_འདས་པ།_ཐ་མི་དད་པ+འབབ_འདས་པ།_###
བཙག | འཚག_འདས་པ།_ཐ་དད་པ
བཙགས | འཚག_འདས་པ།_འབྲི་ཚུལ
བཙང | འཚང_མ་འོངས་པ།_ཐ་མི་དད་པ+འཚང_མ་འོངས་པ།_ཐ་དད་པ
བཙངས | འཚང_འདས་པ།_ཐ་དད་པ+འཚང_འདས་པ།_ཐ་མི་དད་པ
བཙབ | གཙབས_མའོངསཔ_འབྲི་ཚུལ+གཙབས_དལྟབ_འབྲི་ཚུལ+བྱ་ཚིག_ཐ་དད་པ
བཙབས | གཙབས_འདསཔ_འབྲི་ཚུལ+བྱ་ཚིག_ཐ་དད་པ
བཙའ | བཙའ_མ་འོངས་པ།_ཐ་མི་དད་པ+བཙའ_ད་ལྟ་བ།_ཐ་མི་དད་པ
བཙལ | བཙལ_མ་འོངས་པ།_ཐ་དད་པ+བཙལ_འདས་པ།_###+འཚོལ_འདས་པ།_ཐ་དད་པ+འཚོལ_མ་འོངས་པ།_###+བཙལ_འདས་པ།_ཐ་དད་པ+བཙལ_མ་འོངས་པ།_###+འཚོལ_འདས་པ།_###+འཚོལ_མ་འོངས་པ།_ཐ་དད་པ
བཙས | བཙའ_འདས་པ།_ཐ་མི་དད་པ
བཙིར | འཚིར_འདས་པ།_ཐ་དད་པ+བཙིར_མ་འོངས་པ།_ཐ་དད་པ+བཙིར_འདས་པ།_ཐ་དད་པ+འཚིར_མ་འོངས་པ།_ཐ་དད་པ
བཙུགས | འཛུགས_འདས་པ།_ཐ་དད་པ+འཛུགས_འདས་པ།_###
བཙུད | འཛུད_འདས་པ།_ཐ་དད་པ
བཙུམ | འཚུམ_མ་འོངས་པ།_ཐ་དད་པ+གཟུམ_འདས་པ།_ཐ་དད་པ
བཙུམས | འཚུམ_འདས་པ།_ཐ་དད་པ
བཙེམ | འཚེམ_མ་འོངས་པ།_ཐ་དད་པ
བཙེམས | འཚེམ_འདས་པ།_ཐ་དད་པ
བཙེས | གཙེ_འདསཔ_འབྲི་ཚུལ+བྱ་ཚིག_ཐ་དད་པ
བཙོ | འཚོད_མ་འོངས་པ།_ཐ་དད་པ+འཚོད_མ་འོངས་པ།_###
བཙོག | འཚོག_འདས་པ།_ཐ་དད་པ
བཙོགས | འཚོག_འདསཔ_འབྲི་ཚུལ+བཙོག_འབྲི་ཚུལ+བྱ་ཚིག_ཐ་དད་པ
བཙོང | འཚོང_མ་འོངས་པ།_ཐ་དད་པ
བཙོངས | འཚོང_འདས་པ།_ཐ་དད་པ
བཙོས | འཚོད_འདས་པ།_###+འཚོད_འདས་པ།_ཐ་དད་པ
བཞག | འཇོག_འདས་པ།_###+འཇོག_འདས་པ།_ཐ་དད་པ
བཞགས | བྱ་ཚིག_ཐ་དད་པ
བཞད | གཟུགས་མི་འགྱུར་བ_ཐ་མི་དད་པ+བྱ་ཚིག_###
བཞབ | འཇབ_འདས་པ།_ཐ་དད་པ+གཞབ_འདས་པ།_###
བཞམས | གཟུགས་མི་འགྱུར་བ_ཐ་དད་པ
བཞར | བཞར_འདས་པ།_ཐ་དད་པ+གཞར_མ་འོངས་པ།_###+བཞར_མ་འོངས་པ།_ཐ་དད་པ+གཞར_འདས་པ།_###+གཞར_མ་འོངས་པ།_ཐ་དད་པ+གཞར_འདས་པ།_ཐ་དད་པ
བཞིབ | འཇིབ_འདས་པ།_ཐ་དད་པ
བཞུ | བཞུ_མ་འོངས་པ།_ཐ་དད་པ+བཞུ_ད་ལྟ་བ།_ཐ་དད་པ+འཇུ_མ་འོངས་པ།_###
བཞུགས | གཟུགས་མི་འགྱུར་བ_ཐ་མི་དད་པ
བཞུད | གཟུགས་མི་འགྱུར་བ_ཐ་མི་དད་པ
བཞུར | བཞུར_འདས་པ།_ཐ་དད་པ+གཟུགས་མི་འགྱུར་བ_ཐ་མི་དད་པ+གཞུར_འདས་པ།_ཐ་དད་པ
བཞུས | འཇུ_སྐུལ་ཚིག_###+བྱ་ཚིག_###+བཞུ_འདས་པ།_ཐ་དད་པ+འཇུ_འདས་པ།_###+གཞུ_འདསཔ_འབྲི་ཚུལ
བཞེངས | གཟུགས་མི་འགྱུར་བ_ཐ་མི་དད་པ+གཟུགས་མི་འགྱུར་བ_ཐ་དད་པ
བཞེད | གཟུགས་མི་འགྱུར་བ_ཐ་དད་པ
བཞེན | གཟུགས་མི་འགྱུར་བ_ཐ་དད་པ
བཞེས | བྱ་ཚིག_###+གཟུགས་མི་འགྱུར་བ_ཐ་མི་དད་པ+གཟུགས་མི་འགྱུར་བ_ཐ་དད་པ
བཞོ | འཇོ_མ་འོངས་པ།_ཐ་དད་པ
བཞོག | གཞོག_འདས་པ།_ཐ་དད་པ
བཞོན | བཞོན_འདས་པ།_ཐ་དད་པ+ཞོན_མ་འོངས་པ།_ཐ་དད་པ+ཞོན_འདས་པ།_ཐ་དད་པ+བཞོན_མ་འོངས་པ།_ཐ་དད་པ
བཞོར | གཞར_སྐུལ་ཚིག_###+གཞར_སྐུལ་ཚིག_ཐ་དད་པ+བཞར_སྐུལ་ཚིག_ཐ་དད་པ
བཞོལ | གཟུགས་མི་འགྱུར་བ_ཐ་མི་དད་པ
བཞོས | འཇོ_འདས་པ།_ཐ་དད་པ
བཟབ | གཟབ_མ་འོངས་པ།_འབྲི་ཚུལ
བཟབས | གཟབ_འདས་པ།_ཐ་དད་པ
བཟའ | ཟ_མ་འོངས་པ།_ཐ་དད་པ
བཟར | འཛར_འདས་པ།_ཐ་དད་པ
བཟས | ཟ_འདས་པ།_ཐ་དད་པ
བཟི | གཟུགས་མི་འགྱུར་བ_ཐ་མི་དད་པ
བཟུང | འཛིན_འདས་པ།_###+འཛིན_འདས་པ།_ཐ་དད་པ
བཟུར | འཛུར_འདས་པ།_ཐ་མི་དད་པ
བཟེག | འཛེག_མའོངསཔ_འབྲི་ཚུལ+བྱ་ཚིག_ཐ་དད་པ
བཟེད | འཛེད_འདས་པ།_ཐ་དད་པ
བཟོ | བཟོས_ད་ལྟ་བ།_ཐ་དད་པ+བཟོས_མ་འོངས་པ།_ཐ་དད་པ+བཟོ_ད་ལྟ་བ།_ཐ་དད་པ+བཟོ_མ་འོངས་པ།_ཐ་དད་པ
བཟོད | གཟུགས་མི་འགྱུར་བ_ཐ་དད་པ
བཟོས | བཟོ_སྐུལ་ཚིག_ཐ་དད་པ+བཟོས_འདས་པ།_ཐ་དད་པ+བཟོས_སྐུལ་ཚིག_ཐ་དད་པ+བཟོ_འདས་པ།_ཐ་དད་པ
བཟླ | ཟློ_མ་འོངས་པ།_ཐ་དད་པ+ཟློ_མ་འོངས་པ།_###
བཟླས | ཟློ_འདས་པ།_###+ཟློ_འདས་པ།_ཐ་དད་པ
བཟླུག | ཟླུག_མ་འོངས་པ།_ཐ་དད་པ
བཟླུགས | ཟླུག_འདས་པ།_ཐ་དད་པ
བཟླུམ | ཟླུམ_མ་འོངས་པ།_ཐ་དད་པ
བཟླུམས | ཟླུམ_འདས་པ།_ཐ་དད་པ
བཟློ | ཟློ_མ་འོངས་པ།_###+ཟློས_མ་འོངས་པ།_ཐ་དད་པ
བཟློག | ཟློག_མ་འོངས་པ།_###+ཟློག_མ་འོངས་པ།_ཐ་དད་པ
བཟློགས | ཟློག_འདས་པ།_ཐ་དད་པ+ཟློག_འདས་པ།_###
བརྐམ | རྐམ_མ་འོངས་པ།_ཐ་མི་དད་པ
བརྐམས | རྐམ_འདས་པ།_ཐ་མི་དད་པ
བརྐུ | རྐུ_མ་འོངས་པ།_ཐ་དད་པ+རྐུས_མ་འོངས་པ།_ཐ་དད་པ
བརྐུས | རྐུས_འདས་པ།_ཐ་དད་པ+རྐུ_འདས་པ།_ཐ་དད་པ
བརྐོ | རྐོ_མ་འོངས་པ།_ཐ་དད་པ+རྐོས_མ་འོངས་པ།_ཐ་དད་པ
བརྐོས | རྐོ_འདས་པ།_ཐ་དད་པ+རྐོས_འདས་པ།_ཐ་དད་པ
བརྐྱང | རྐྱོང_མ་འོངས་པ།_ཐ་དད་པ
བརྐྱངས | རྐྱོང_འདས་པ།_ཐ་དད་པ
བརྒད | བགད_འབྲི་ཚུལ+བྱ་ཚིག_ཐ་དད་པ
བརྒལ | རྒལ_མ་འོངས་པ།_ཐ་མི་དད་པ+བརྒལ_མ་འོངས་པ།_ཐ་དད་པ+རྒལ_མ་འོངས་པ།_###+རྒལ_མ་འོངས་པ།_ཐ་དད་པ+རྒལ_འདས་པ།_###+རྒལ_འདས་པ།_ཐ་མི་དད་པ+བརྒལ_འདས་པ།_ཐ་དད་པ+རྒལ_འདས་པ།_ཐ་དད་པ
བརྒྱག | རྒྱག_མ་འོངས་པ།_###+རྒྱགས_མ་འོངས་པ།_ཐ་མི་དད་པ+རྒྱག_མ་འོངས་པ།_ཐ་དད་པ+རྒྱགས_མ་འོངས་པ།_###
བརྒྱགས | རྒྱག_འདས་པ།_###+གཟུགས་མི་འགྱུར་བ_ཐ་མི་དད་པ+རྒྱགས_འདས་པ།_ཐ་མི་དད་པ+རྒྱགས_འདས་པ།_###
བརྒྱང | རྒྱོང_མ་འོངས་པ།_ཐ་མི་དད་པ
བརྒྱངས | རྒྱོང_འདས་པ།_ཐ་མི་དད་པ
བརྒྱན | བརྒྱན_མ་འོངས་པ།_ཐ་དད་པ+རྒྱན_མ་འོངས་པ།_ཐ་དད་པ+རྒྱན_འདས་པ།_ཐ་དད་པ+བརྒྱན_འདས་པ།_ཐ་དད་པ
བརྒྱབ | རྒྱག_འདས་པ།_###+རྒྱག_འདས་པ།_ཐ་དད་པ
བརྒྱལ | གཟུགས་མི་འགྱུར་བ_ཐ་མི་དད་པ+བྱ་ཚིག_###
བརྒྱུ | རྒྱུད_མ་འོངས་པ།_འབྲི་ཚུལ+རྒྱུད_མ་འོངས་པ།_ཐ་དད་པ
བརྒྱུག | རྒྱུག_མ་འོངས་པ།_ཐ་མི་དད་པ+རྒྱུག_མ་འོངས་པ།_###
བརྒྱུགས | རྒྱུག_འདས་པ།_ཐ་མི་དད་པ+རྒྱུག_འདས་པ།_###
བརྒྱུང | རྒྱུང_མ་འོངས་པ།_ཐ་དད་པ
བརྒྱུངས | རྒྱུང_འདས་པ།_ཐ་དད་པ
བརྒྱུད | བྱ་ཚིག_###+གཟུགས་མི་འགྱུར་བ_ཐ་དད་པ
བརྒྱུས | རྒྱུད_འདས་པ།_འབྲི་ཚུལ+རྒྱུད_འདས་པ།_ཐ་དད་པ
བརྒྱོ | རྒྱོ_མ་འོངས་པ།_ཐ་དད་པ
བརྒྱོས | རྒྱོ_འདས་པ།_ཐ་དད་པ
བརྔ | རྔ_མ་འོངས་པ།_ཐ་དད་པ
བརྔད | གཟུགས་མི་འགྱུར་བ_ཐ་དད་པ
བརྔན | བརྔན_འདས་པ།_ཐ་དད་པ+བརྔན_མ་འོངས་པ།_ཐ་དད་པ+རྔན_འདས་པ།_ཐ་དད་པ+རྔན_མ་འོངས་པ།_###+རྔན_མ་འོངས་པ།_ཐ་དད་པ+རྔན_འདས་པ།_###
བརྔབ | རྔབ_མ་འོངས་པ།_ཐ་མི་དད་པ
བརྔབས | རྔབ_འདས་པ།_ཐ་མི་དད་པ
བརྔམ | བརྔམས_མ་འོངས་པ།_ཐ་དད་པ+རྔམ_མ་འོངས་པ།_ཐ་མི་དད་པ+རྔམ_མ་འོངས་པ།_ཐ་དད་པ
བརྔམས | རྔམ_འདས་པ།_ཐ་དད་པ+རྔམ_འདས་པ།_ཐ་མི་དད་པ+བརྔམས_འདས་པ།_ཐ་དད་པ
བརྔས | རྔ_འདས་པ།_ཐ་དད་པ
བརྔུབ | རྔུབ_མ་འོངས་པ།_ཐ་དད་པ
བརྔུབས | རྔུབ_འདས་པ།_ཐ་དད་པ
བརྔོ | རྔོད_མ་འོངས་པ།_###+རྔོད_མ་འོངས་པ།_ཐ་དད་པ+རྔོས_མ་འོངས་པ།_###
བརྔོད | རྔོད_འདས་པ།_ཐ་དད་པ+བརྔོད_མ་འོངས་པ།_ཐ་དད་པ+བརྔོད_འདས་པ།_ཐ་དད་པ+རྔོད_མ་འོངས་པ།_ཐ་དད་པ
བརྔོན | རྔོན_མ་འོངས་པ།_###+རྔོན_འདས་པ།_###+བརྔོན_མ་འོངས་པ།_ཐ་དད་པ+བརྔོན_འདས་པ།_ཐ་དད་པ
བརྔོས | རྔོད_འདས་པ།_ཐ་དད་པ+རྔོས_འདས་པ།_###+རྔོད_འདས་པ།_###
བརྗེ | རྗེ_མ་འོངས་པ།_ཐ་དད་པ
བརྗེད | བརྗེད_འདས་པ།_###+རྗེད_འདས་པ།_ཐ་དད་པ+རྗེད_མ་འོངས་པ།_ཐ་མི་དད་པ+བརྗེད_མ་འོངས་པ།_ཐ་དད་པ+བརྗེད_འདས་པ།_ཐ་དད་པ+རྗེད_མ་འོངས་པ།_ཐ་དད་པ+བརྗེད_མ་འོངས་པ།_###
བརྗེས | རྗེད_འདས་པ།_ཐ་མི་དད་པ+རྗེ_འདས་པ།_ཐ་དད་པ
བརྗོད | བརྗོད_འདས་པ།_ཐ་དད་པ+བརྗོད_མ་འོངས་པ།_ཐ་དད་པ+རྗོད_འདས་པ།_ཐ་དད་པ+རྗོད_མ་འོངས་པ།_ཐ་དད་པ
བརྙ | རྙ_མ་འོངས་པ།_ཐ་དད་པ
བརྙང | རྙང_མ་འོངས་པ།_ཐ་དད་པ
བརྙངས | རྙང_འདས་པ།_ཐ་དད་པ
བརྙན | བརྙན_མ་འོངས་པ།_ཐ་དད་པ+བརྙན_འདས་པ།_ཐ་དད་པ+རྙོན_འདས་པ།_ཐ་དད་པ+རྙོན_མ་འོངས་པ།_ཐ་དད་པ
བརྙབ | རྙབ_མ་འོངས་པ།_ཐ་དད་པ
བརྙབས | རྙབ_འདས་པ།_ཐ་དད་པ
བརྙས | རྙ_འདས་པ།_ཐ་དད་པ+གཟུགས་མི་འགྱུར་བ_ཐ་དད་པ
བརྙིང | རྙིང_མ་འོངས་པ།_ཐ་མི་དད་པ+བརྙིང_མ་འོངས་པ།_ཐ་མི་དད་པ
བརྙིངས | བརྙིང_འདས་པ།_ཐ་མི་དད་པ+རྙིང_འདས་པ།_ཐ་མི་དད་པ
བརྙིད | བྱ་ཚིག_ཐ་མི་དད་པ+རྙིད_མའོངསཔ_འབྲི་ཚུལ
བརྙིས | རྙིད_འདསཔ_འབྲི་ཚུལ+བྱ་ཚིག_ཐ་མི་དད་པ
བརྙེས | གཟུགས་མི་འགྱུར་བ_ཐ་མི་དད་པ+བྱ་ཚིག_###
བརྙོག | རྙོག_མ་འོངས་པ།_ཐ་དད་པ
བརྙོགས | རྙོག_འདས་པ།_ཐ་དད་པ
བརྙོང | རྙོང_མ་འོངས་པ།_###+རྙོང_མ་འོངས་པ།_ཐ་དད་པ+རྙོང_མ་འོངས་པ།_ཐ་མི་དད་པ
བརྙོངས | རྙོང_འདས་པ།_ཐ་དད་པ+རྙོང_འདས་པ།_###+རྙོང_འདས་པ།_ཐ་མི་དད་པ
བརྙོས | བྱ་ཚིག_ཐ་དད་པ
བརྟ | རྟས_མ་འོངས་པ།_ཐ་མི་དད་པ
བརྟག | རྟོག_མ་འོངས་པ།_ཐ་དད་པ
བརྟགས | རྟོག_འདས་པ།_ཐ་དད་པ
བརྟན | བརྟན_འདས་པ།_ཐ་དད་པ+རྟོན_མ་འོངས་པ།_ཐ་དད་པ+བརྟན_མ་འོངས་པ།_ཐ་དད་པ+རྟོན_འདས་པ།_ཐ་དད་པ
བརྟབ | རྟབ_མ་འོངས་པ།_ཐ་མི་དད་པ
བརྟབས | རྟབ_འདས་པ།_ཐ་མི་དད་པ
བརྟས | རྟས_འདས་པ།_ཐ་མི་དད་པ
བརྟིབ | རྟིབ_མ་འོངས་པ།_འབྲི་ཚུལ
བརྟིབས | རྟིབ_འདས་པ།_འབྲི་ཚུལ
བརྟུན | རྟུན_འདས་པ།_ཐ་དད་པ+རྟུན_མ་འོངས་པ།_ཐ་དད་པ+བརྟུན_འདས་པ།_ཐ་དད་པ+བརྟུན_མ་འོངས་པ།_ཐ་དད་པ
བརྟུལ | རྟུལ_འདས་པ།_ཐ་དད་པ+བརྟུལ_འདས་པ།_ཐ་དད་པ+རྟུལ_མ་འོངས་པ།_ཐ་དད་པ+རྟུལ_མ་འོངས་པ།_###+རྟུལ_འདས་པ།_###+བརྟུལ_མ་འོངས་པ།_ཐ་དད་པ
བརྟེན | བརྟེན_མ་འོངས་པ།_ཐ་དད་པ+རྟེན_འདས་པ།_ཐ་མི་དད་པ+རྟེན_མ་འོངས་པ།_ཐ་མི་དད་པ+བརྟེན_འདས་པ།_ཐ་དད་པ
བརྟོད | བརྟོད_མ་འོངས་པ།_ཐ་དད་པ+རྟོད_མ་འོངས་པ།_ཐ་དད་པ+རྟོད_འདས་པ།_ཐ་དད་པ+བརྟོད_འདས་པ།_ཐ་དད་པ
བརྟོལ | རྟོལ_མ་འོངས་པ།_ཐ་དད་པ+བརྟོལ_འདས་པ།_ཐ་དད་པ+རྟོལ_འདས་པ།_ཐ་དད་པ+བརྟོལ_མ་འོངས་པ།_ཐ་དད་པ+རྟོལ_མ་འོངས་པ།_ཐ་མི་དད་པ+རྟོལ_འདས་པ།_ཐ་མི་དད་པ+རྟོལ_མ་འོངས་པ།_###+རྟོལ_འདས་པ།_###
བརྡབ | རྡེབ_མ་འོངས་པ།_ཐ་དད་པ+རྡེབ_མ་འོངས་པ།_###+རྡབ_མ་འོངས་པ།_ཐ་མི་དད་པ
བརྡབས | རྡེབ_འདས་པ།_ཐ་དད་པ+རྡེབ_འདས་པ།_###+རྡབ_འདས་པ།_ཐ་མི་དད་པ
བརྡར | རྡར_མ་འོངས་པ།_ཐ་དད་པ+བརྡར_མ་འོངས་པ།_ཐ་དད་པ+རྡར_འདས་པ།_###+རྡར_འདས་པ།_ཐ་དད་པ+རྡར_མ་འོངས་པ།_###+བརྡར_འདས་པ།_ཐ་དད་པ
བརྡལ | བརྡལ_མ་འོངས་པ།_ཐ་དད་པ+རྡལ_འདས་པ།_ཐ་དད་པ+བརྡལ_འདས་པ།_ཐ་དད་པ+རྡལ_མ་འོངས་པ།_ཐ་དད་པ
བརྡིབ | རྡིབ_མ་འོངས་པ།_###+རྡིབ_མ་འོངས་པ།_ཐ་མི་དད་པ+བརྡིབས_མ་འོངས་པ།_ཐ་མི་དད་པ
བརྡིབས | རྡིབ_འདས་པ།_ཐ་མི་དད་པ+རྡིབ_འདས་པ།_###+བརྡིབས_འདས་པ།_ཐ་མི་དད་པ
བརྡུང | རྡུང_མ་འོངས་པ།_###+རྡུང_མ་འོངས་པ།_ཐ་དད་པ
བརྡུངས | རྡུང_འདས་པ།_ཐ་དད་པ+རྡུང_འདས་པ།_###
བརྡེག | རྡེག_མ་འོངས་པ།_ཐ་དད་པ
བརྡེགས | རྡེག_འདས་པ།_ཐ་དད་པ
བརྡོལ | རྡོལ_མ་འོངས་པ།_ཐ་མི་དད་པ+རྡོལ_འདས་པ།_ཐ་མི་དད་པ+བརྡོལ_འདས་པ།_ཐ་མི་དད་པ+རྡོལ_མ་འོངས་པ།_###+རྡོལ_འདས་པ།_###+བརྡོལ_མ་འོངས་པ།_ཐ་མི་དད་པ
བརྡོས | གཟུགས་མི་འགྱུར་བ_ཐ་མི་དད་པ
བརྣག | རྣོག_མ་འོངས་པ།_###
བརྣགས | རྣོག_འདས་པ།_###
བརྣང | རྣོང_མ་འོངས་པ།_ཐ་དད་པ
བརྣངས | རྣོང_འདས་པ།_ཐ་དད་པ
བརྣན | བརྣན_མ་འོངས་པ།_ཐ་དད་པ+བརྣན_འདས་པ།_ཐ་དད་པ+རྣོན_མ་འོངས་པ།_ཐ་དད་པ+རྣོན_འདས་པ།_ཐ་དད་པ
བརྣབ | རྣབ_མ་འོངས་པ།_ཐ་དད་པ
བརྣབས | རྣབ_འདས་པ།_ཐ་དད་པ
བརྣུ | རྣུ_མ་འོངས་པ།_ཐ་དད་པ
བརྣུར | རྣུ_འདས་པ།_ཐ་དད་པ
བརྣོག | རྣོག_མ་འོངས་པ།_###+རྣོག_མ་འོངས་པ།_ཐ་དད་པ
བརྣོགས | རྣོག_འདས་པ།_ཐ་དད་པ+རྣོག_འདས་པ།_###
བརྩད | བརྩད_འདས་པ།_ཐ་དད་པ+རྩོད_མ་འོངས་པ།_ཐ་དད་པ+རྩོད_འདས་པ།_ཐ་དད་པ+བརྩད_མ་འོངས་པ།_ཐ་དད་པ
བརྩམ | རྩོམ_མ་འོངས་པ།_###+རྩོམ_མ་འོངས་པ།_ཐ་དད་པ
བརྩམས | བྱ་ཚིག_###+རྩོམ_འདས་པ།_ཐ་དད་པ+རྩོམ_འདས་པ།_###
བརྩལ | བརྩལ_མ་འོངས་པ།_ཐ་དད་པ+བརྩལ_འདས་པ།_ཐ་དད་པ
བརྩི | རྩི_མ་འོངས་པ།_ཐ་དད་པ
བརྩིག | རྩིག_མ་འོངས་པ།_ཐ་དད་པ
བརྩིགས | རྩིག_འདས་པ།_ཐ་དད་པ
བརྩིངས | བྱ་ཚིག_###+རྩེང_འདསཔ_འབྲི་ཚུལ
བརྩིས | རྩི_འདས་པ།_ཐ་དད་པ
བརྩེ | རྩེ_མ་འོངས་པ།_ཐ་མི་དད་པ+བྱ་ཚིག_###+གཟུགས་མི་འགྱུར་བ_ཐ་མི་དད་པ+གཟུགས་མི་འགྱུར་བ_ཐ་དད་པ
བརྩེག | རྩེག_མ་འོངས་པ།_###+རྩེག_མ་འོངས་པ།_ཐ་དད་པ
བརྩེགས | རྩེག_འདས་པ།_###+རྩེག_འདས་པ།_ཐ་དད་པ
བརྩེང | རྩེང_མ་འོངས་པ།_###+རྩེང_མ་འོངས་པ།_ཐ་དད་པ
བརྩེངས | རྩེང_འདས་པ།_ཐ་དད་པ+རྩེང_འདས་པ།_###
བརྩེས | རྩེ_འདས་པ།_ཐ་མི་དད་པ
བརྩོན | གཟུགས་མི་འགྱུར་བ_ཐ་དད་པ
བརྫང | རྫོང_མ་འོངས་པ།_ཐ་དད་པ+རྫོང_མ་འོངས་པ།_###
བརྫངས | རྫོང_འདས་པ།_ཐ་དད་པ+རྫོང_འདས་པ།_###
བརྫད | རྫོད_མ་འོངས་པ།_ཐ་དད་པ+རྫོད_འདས་པ།_ཐ་དད་པ
བརྫས | རྫོ_འདས་པ།_ཐ་དད་པ
བརྫི | རྫི_མ་འོངས་པ།_###+རྫི_མ་འོངས་པ།_ཐ་དད་པ
བརྫིས | རྫི_འདས་པ།_###+རྫི_འདས་པ།_ཐ་དད་པ
བརྫུ | རྫུ_མ་འོངས་པ།_ཐ་དད་པ
བརྫུས | རྫུ_འདས་པ།_ཐ་དད་པ
བརྫེ | རྫེ_མ་འོངས་པ།_ཐ་དད་པ
བརྫེས | རྫེ_འདས་པ།_ཐ་དད་པ
བརྫོ | རྫོ_མ་འོངས་པ།_ཐ་དད་པ
བརྫོག | རྫོག_མ་འོངས་པ།_###+རྫོག_མ་འོངས་པ།_ཐ་དད་པ
བརྫོགས | རྫོག_འདས་པ།_###+རྫོག_འདས་པ།_ཐ་དད་པ
བརླག | བརླགས_མ་འོངས་པ།_ཐ་དད་པ+རླག_མ་འོངས་པ།_###+རླག_མ་འོངས་པ།_ཐ་དད་པ
བརླགས | བརླགས_འདས་པ།_ཐ་དད་པ+རླག_འདས་པ།_###+རླག_འདས་པ།_ཐ་དད་པ
བརླན | བརླན_འདས་པ།_ཐ་དད་པ+རློན_མ་འོངས་པ།_ཐ་དད་པ+རློན_འདས་པ།_ཐ་དད་པ+བརླན_མ་འོངས་པ།_ཐ་དད་པ
བརླབ | རློབ_མ་འོངས་པ།_ཐ་དད་པ
བརླབས | རློབ_འདས་པ།_ཐ་དད་པ
བརླམ | རློམ_མ་འོངས་པ།_ཐ་དད་པ
བརླམས | རློམ_འདས་པ།_ཐ་དད་པ
བརླིང | གཟུགས་མི་འགྱུར་བ_ཐ་མི་དད་པ+རླིང_མ་འོངས་པ།_ཐ་མི་དད་པ
བརླིངས | རླིང_འདས་པ།_ཐ་མི་དད་པ
བརློང | རློང_མ་འོངས་པ།_ཐ་དད་པ
བརློངས | རློང_འདས་པ།_ཐ་དད་པ
བལ | འབལ_འདས་པ།_ཐ་དད་པ
བལྟ | ལྟ_མ་འོངས་པ།_###+ལྟ_མ་འོངས་པ།_ཐ་དད་པ
བལྟབ | ལྟབ_མ་འོངས་པ།_ཐ་དད་པ
བལྟབས | ལྟབ_འདས་པ།_ཐ་དད་པ
བལྟམ | ལྟེམ_མ་འོངས་པ།_ཐ་མི་དད་པ+ལྟམ_མ་འོངས་པ།_ཐ་མི་དད་པ+བལྟམས_མ་འོངས་པ།_###+ལྟེམ_མ་འོངས་པ།_###
བལྟམས | ལྟམ_འདས་པ།_ཐ་མི་དད་པ+བལྟམས_འདས་པ།_###+ལྟེམ_འདས་པ།_ཐ་མི་དད་པ+ལྟེམ_འདས་པ།_###
བལྟས | ལྟ_འདས་པ།_ཐ་དད་པ+ལྟ_འདས་པ།_###
བལྟེབ | ལྟེབ_མ་འོངས་པ།_ཐ་དད་པ
བལྟེབས | ལྟེབ_འདས་པ།_ཐ་དད་པ
བལྡག | བལྡགས_མ་འོངས་པ།_ཐ་དད་པ+ལྡག_མ་འོངས་པ།_ཐ་དད་པ
བལྡགས | བལྡགས_འདས་པ།_ཐ་དད་པ+ལྡག_འདས་པ།_ཐ་དད་པ
བལྡད | ལྡད_འདས་པ།_ཐ་དད་པ+བལྡད_མ་འོངས་པ།_ཐ་དད་པ+ལྡད_མ་འོངས་པ།_ཐ་དད་པ+བལྡད_འདས་པ།_ཐ་དད་པ
བལྡབ | ལྡབ_མ་འོངས་པ།_ཐ་དད་པ+ལྡོབས_མ་འོངས་པ།_ཐ་དད་པ
བལྡབས | ལྡོབས_འདས་པ།_ཐ་དད་པ+ལྡབ_འདས་པ།_ཐ་དད་པ
བལྡེག | ལྡེག_མ་འོངས་པ།_ཐ་དད་པ+ལྡེག_མ་འོངས་པ།_ཐ་མི་དད་པ
བལྡེགས | ལྡེག_འདས་པ།_ཐ་དད་པ+ལྡེག_འདས་པ།_ཐ་མི་དད་པ
བཤག | བཤགས_མ་འོངས་པ།_འབྲི་ཚུལ+འཆགས_མ་འོངས་པ།_འབྲི་ཚུལ
བཤགས | བཤགས_འདས་པ།_འབྲི་ཚུལ+འཆགས_འདས་པ།_འབྲི་ཚུལ
བཤང | གཤོང_མ་འོངས་པ།_ཐ་དད་པ+གཤོང_མ་འོངས་པ།_###
བཤངས | གཤོང_འདས་པ།_ཐ་དད་པ+གཤོང_འདས་པ།_###
བཤད | བཤད_འདས་པ།_ཐ་དད་པ+འཆད_འདས་པ།_ཐ་དད་པ+འཆད_མ་འོངས་པ།_ཐ་དད་པ+བཤད_མ་འོངས་པ།_ཐ་དད་པ
བཤམ | གཤོམ_མ་འོངས་པ།_ཐ་དད་པ+གཤོམ_མ་འོངས་པ།_###
བཤམས | གཤོམ_འདས་པ།_ཐ་དད་པ+ཤུམས_འདས་པ།_ཐ་མི་དད་པ+གཤོམ_འདས་པ།_###
བཤའ | བཤའ_མ་འོངས་པ།_ཐ་དད་པ+བཤའ_ད་ལྟ་བ།_ཐ་དད་པ
བཤར | གཤོར_འདས་པ།_###+གཤར_འདས་པ།_ཐ་མི་དད་པ+གཤོར_མ་འོངས་པ།_###
བཤལ | བཤལ_ད་ལྟ་བ།_###+བཤལ_འདས་པ།_ཐ་མི་དད་པ+བཤལ_འདས་པ།_ཐ་དད་པ+བཤལ_མ་འོངས་པ།_ཐ་དད་པ+བཤལ_མ་འོངས་པ།_###+བཤལ_ད་ལྟ་བ།_ཐ་མི་དད་པ+བཤལ_ད་ལྟ་བ།_ཐ་དད་པ+བཤལ_འདས་པ།_###+བཤལ_མ་འོངས་པ།_ཐ་མི་དད་པ
བཤས | བཤའ_འདས་པ།_ཐ་དད་པ
བཤིག | ཤིག_མ་འོངས་པ།_ཐ་དད་པ+འཇིག_འདས་པ།_ཐ་དད་པ
བཤིགས | ཤིག_འདས་པ།_ཐ་དད་པ
བཤིབ | བྱ་ཚིག_ཐ་དད་པ
བཤིབས | བྱ་ཚིག_ཐ་དད་པ
བཤུ | བཤུ_ད་ལྟ་བ།_ཐ་དད་པ+བཤུ_མ་འོངས་པ།_ཐ་དད་པ+གཤུ_མ་འོངས་པ།_ཐ་དད་པ+བཤུ_མ་འོངས་པ།_###+བཤུ_ད་ལྟ་བ།_###
བཤུག | ཤུག_མ་འོངས་པ།_ཐ་དད་པ
བཤུགས | ཤུག_འདས་པ།_ཐ་དད་པ
བཤུང | གཤུང_མ་འོངས་པ།_ཐ་དད་པ
བཤུངས | གཤུང_འདས་པ།_ཐ་དད་པ
བཤུད | བཤུད_མ་འོངས་པ།_ཐ་དད་པ+བཤུད_སྐུལ་ཚིག_###+གཤུད_སྐུལ་ཚིག_ཐ་དད་པ+བཤུད_འདས་པ།_ཐ་དད་པ+བཤུད_འདས་པ།_###+བཤུད_ད་ལྟ་བ།_ཐ་དད་པ+གཤུད_འདས་པ།_ཐ་དད་པ
བཤུབ | ཤུབ_མ་འོངས་པ།_ཐ་དད་པ
བཤུབས | ཤུབ_འདས་པ།_ཐ་དད་པ
བཤུམ | ཤུམས_མ་འོངས་པ།_ཐ་མི་དད་པ+ཤུམ_མ་འོངས་པ།_ཐ་མི་དད་པ
བཤུམས | ཤུམ_འདས་པ།_ཐ་མི་དད་པ
བཤུར | བཤུར_མ་འོངས་པ།_ཐ་དད་པ+བཤུར_འདས་པ།_ཐ་དད་པ+གཤུར_འདས་པ།_ཐ་དད་པ+གཤུར_མ་འོངས་པ།_ཐ་དད་པ
བཤུས | གཤུ_འདས་པ།_ཐ་དད་པ+བཤུ_འདས་པ།_ཐ་དད་པ+གཤུ_སྐུལ་ཚིག_ཐ་དད་པ+བཤུ_འདས་པ།_###
བཤེད | གཟུགས་མི་འགྱུར་བ_ཐ་དད་པ
བཤེར | བཤེར_མ་འོངས་པ།_ཐ་དད་པ+གཤེར_འདས་པ།_###+བཤེར_འདས་པ།_ཐ་དད་པ+གཤེར_མ་འོངས་པ།_###
བཤོ | གཤོ_མ་འོངས་པ།_ཐ་དད་པ+བཤོ_ད་ལྟ་བ།_###+བཤོ_མ་འོངས་པ།_###
བཤོགས | ཤོགས_འབྲི་ཚུལ+བྱ་ཚིག_ཐ་དད་པ
བཤོར | བཤོར_འདས་པ།_ཐ་དད་པ+གཤོར_མ་འོངས་པ།_ཐ་དད་པ+གཤོར_འདས་པ།_ཐ་དད་པ+བཤོར_མ་འོངས་པ།_ཐ་དད་པ
བཤོལ | གཟུགས་མི་འགྱུར་བ_ཐ་མི་དད་པ+གཟུགས་མི་འགྱུར་བ_ཐ་དད་པ
བཤོས | བཤོ_འདས་པ།_###+བཤའ_སྐུལ་ཚིག_ཐ་དད་པ+བཤོ_སྐུལ་ཚིག_###+གཤོ_འདས་པ།_ཐ་དད་པ
བསག | གསོག_མ་འོངས་པ།_###+གསོག_མ་འོངས་པ།_ཐ་དད་པ
བསགས | གསོག_འདས་པ།_ཐ་དད་པ+གསོག_འདས་པ།_###
བསང | བསང_ད་ལྟ་བ།_ཐ་དད་པ+བསང_མ་འོངས་པ།_ཐ་དད་པ
བསངས | བསང_འདས་པ།_ཐ་དད་པ
བསད | གསོད_འདས་པ།_###+གསོད_འདས་པ།_ཐ་དད་པ
བསབ | གསོབ_མ་འོངས་པ།_###+གསོབ_མ་འོངས་པ།_ཐ་དད་པ
བསབས | གསོབ_འདས་པ།_###+གསོབ_འདས་པ།_ཐ་དད་པ
བསམ | སེམས_མ་འོངས་པ།_ཐ་དད་པ
བསམས | སེམས_འདས་པ།_ཐ་དད་པ
བསར | གསོར_འདས་པ།_###+གསོར_མ་འོངས་པ།_###+བསར_འདས་པ།_ཐ་དད་པ+བསར_མ་འོངས་པ།_ཐ་དད་པ
བསལ | སེལ_མ་འོངས་པ།_###+སེལ_འདས་པ།_###+བསལ_མ་འོངས་པ།_ཐ་དད་པ+སེལ_མ་འོངས་པ།_ཐ་དད་པ+བསལ_འདས་པ།_ཐ་དད་པ+སེལ_འདས་པ།_ཐ་དད་པ
བསིག | གསིག_མ་འོངས་པ།_ཐ་དད་པ
བསིགས | གསིག_འདས་པ།_ཐ་དད་པ
བསིང | གསིང_མ་འོངས་པ།_ཐ་དད་པ
བསིངས | གསིང_འདས་པ།_ཐ་དད་པ
བསིར | བསིར_མ་འོངས་པ།_ཐ་དད་པ+གསིར_མ་འོངས་པ།_ཐ་དད་པ+གསིར_འདས་པ།_ཐ་དད་པ+བསིར_འདས་པ།_ཐ་དད་པ
བསིལ | བསིལ_འདས་པ།_ཐ་དད་པ+གསིལ_འདས་པ།_ཐ་དད་པ+གསིལ_མ་འོངས་པ།_###+གསིལ_མ་འོངས་པ།_ཐ་དད་པ+བསིལ_མ་འོངས་པ།_ཐ་དད་པ+གསིལ_འདས་པ།_###
བསུ | བསུས_ད་ལྟ་བ།_ཐ་དད་པ+བསུས_མ་འོངས་པ།_ཐ་དད་པ+བསུ_ད་ལྟ་བ།_ཐ་དད་པ+བསུ_མ་འོངས་པ།_ཐ་དད་པ
བསུན | བསུན_མ་འོངས་པ།_ཐ་མི་དད་པ+བསུན_འདས་པ།_ཐ་མི་དད་པ+སུན_འདས་པ།_ཐ་མི་དད་པ+སུན_མ་འོངས་པ།_ཐ་མི་དད་པ
བསུབ | སུབ_མ་འོངས་པ།_ཐ་དད་པ
བསུབས | སུབ_འདས་པ།_ཐ་དད་པ+གསུབ_འདས་པ།_ཐ་དད་པ
བསུམ | སུམ_མ་འོངས་པ།_ཐ་དད་པ
བསུམས | སུམ_འདས་པ།_ཐ་དད་པ
བསུས | བསུ_སྐུལ་ཚིག_ཐ་དད་པ+བསུ_འདས་པ།_ཐ་དད་པ+བསུས_འདས་པ།_ཐ་དད་པ+བསུས_སྐུལ་ཚིག_ཐ་དད་པ
བསེག | གསེག_མ་འོངས་པ།_ཐ་དད་པ
བསེགས | གསེག_འདས་པ།_ཐ་དད་པ
བསེད | གསེད_སྐུལ་ཚིག_ཐ་དད་པ+བསེད_སྐུལ་ཚིག_ཐ་དད་པ+གསེད_འདས་པ།_ཐ་དད་པ+བསེད_འདས་པ།_ཐ་དད་པ
བསེར | གཟུགས་མི་འགྱུར་བ_ཐ་མི་དད་པ+བྱ་ཚིག_###
བསོ | བསོ_ད་ལྟ་བ།_ཐ་མི་དད་པ+བསོ_མ་འོངས་པ།_ཐ་མི་དད་པ
བསོག | གསོག_མའོངསཔ_འབྲི་ཚུལ+བྱ་ཚིག_ཐ་དད་པ
བསོགས | གསོག_འདསཔ_འབྲི་ཚུལ+བྱ་ཚིག_ཐ་དད་པ
བསོངས | བསང_སྐུལཚིག_འབྲི་ཚུལ
བསོད | གཟུགས་མི་འགྱུར་བ_ཐ་མི་དད་པ
བསོར | གསོར_མ་འོངས་པ།_ཐ་དད་པ+གསོར_འདས་པ།_ཐ་དད་པ+བསོར_མ་འོངས་པ།_ཐ་དད་པ+བསོར_འདས་པ།_ཐ་དད་པ
བསོས | བསོ_འདས་པ།_ཐ་མི་དད་པ
བསྐང | སྐོང_མ་འོངས་པ།_###+སྐོང_མ་འོངས་པ།_ཐ་དད་པ
བསྐངས | སྐོང_འདས་པ།_###+སྐོང_འདས་པ།_ཐ་དད་པ
བསྐམ | སྐེམ_མ་འོངས་པ།_ཐ་མི་དད་པ+སྐེམ_མ་འོངས་པ།_ཐ་དད་པ
བསྐམས | སྐེམ_འདས་པ།_ཐ་མི་དད་པ+སྐེམ_འདས་པ།_ཐ་དད་པ
བསྐལ | གཟུགས་མི་འགྱུར་བ_ཐ་མི་དད་པ
བསྐུ | སྐུད_མ་འོངས་པ།_ཐ་དད་པ
བསྐུག | སྐུག_མ་འོངས་པ།_ཐ་དད་པ
བསྐུགས | སྐུག_འདས་པ།_ཐ་དད་པ
བསྐུང | སྐུང_མ་འོངས་པ།_ཐ་དད་པ
བསྐུངས | སྐུང_འདས་པ།_ཐ་དད་པ
བསྐུམ | སྐུམ_མ་འོངས་པ།_ཐ་དད་པ
བསྐུམས | སྐུམ_འདས་པ།_ཐ་དད་པ
བསྐུར | སྐུར_འདས་པ།_###+སྐུར_མ་འོངས་པ།_ཐ་དད་པ+སྐུར_མ་འོངས་པ།_###+སྐུར_འདས་པ།_ཐ་དད་པ+བསྐུར_འདས་པ།_ཐ་དད་པ+བསྐུར_མ་འོངས་པ།_ཐ་དད་པ
བསྐུལ | བསྐུལ_མ་འོངས་པ།_ཐ་དད་པ+སྐུལ_མ་འོངས་པ།_ཐ་དད་པ+བསྐུལ_འདས་པ།_ཐ་དད་པ+སྐུལ_འདས་པ།_ཐ་དད་པ
བསྐུས | སྐུད_འདས་པ།_ཐ་དད་པ
བསྐོ | སྐོ_མ་འོངས་པ།_ཐ་དད་པ
བསྐོང | སྐོང_མ་འོངས་པ།_###
བསྐོངས | སྐོང_འདས་པ།_###
བསྐོན | བསྐོན_མ་འོངས་པ།_ཐ་དད་པ+སྐོན_མ་འོངས་པ།_ཐ་དད་པ+བསྐོན_འདས་པ།_ཐ་དད་པ+སྐོན_འདས་པ།_ཐ་དད་པ
བསྐོར | བསྐོར_འདས་པ།_ཐ་དད་པ+སྐོར_མ་འོངས་པ།_ཐ་དད་པ+སྐོར_འདས་པ།_###+སྐོར_མ་འོངས་པ།_###+སྐོར_འདས་པ།_ཐ་དད་པ+བསྐོར_མ་འོངས་པ།_ཐ་དད་པ
བསྐོལ | བསྐོལ_འདས་པ།_ཐ་དད་པ+སྐོལ_མ་འོངས་པ།_ཐ་དད་པ+སྐོལ_སྐུལ་ཚིག_ཐ་དད་པ+སྐོལ_འདས་པ།_ཐ་དད་པ+བསྐོལ_མ་འོངས་པ།_ཐ་དད་པ
བསྐོས | སྐོ_འདས་པ།_ཐ་དད་པ
བསྐྱ | སྐྱ_མ་འོངས་པ།_ཐ་དད་པ
བསྐྱང | སྐྱོང_མ་འོངས་པ།_###+བསྐྱང_མ་འོངས་པ།_ཐ་དད་པ+སྐྱོང_མ་འོངས་པ།_ཐ་དད་པ+བསྐྱངས_མ་འོངས་པ།_ཐ་དད་པ
བསྐྱངས | བསྐྱང_འདས་པ།_ཐ་དད་པ+བསྐྱངས_འདས་པ།_ཐ་དད་པ+སྐྱོང_འདས་པ།_ཐ་དད་པ+སྐྱོང_འདས་པ།_###
བསྐྱབ | སྐྱོབ_མ་འོངས་པ།_ཐ་དད་པ+བསྐྱབས_མ་འོངས་པ།_ཐ་དད་པ
བསྐྱབས | བསྐྱབས_འདས་པ།_ཐ་དད་པ+སྐྱོབ_འདས་པ།_ཐ་དད་པ
བསྐྱམ | སྐྱོམ_མ་འོངས་པ།_ཐ་དད་པ
བསྐྱམས | སྐྱོམ_འདས་པ།_ཐ་དད་པ
བསྐྱར | སྐྱོར_མ་འོངས་པ།_ཐ་དད་པ+བསྐྱོར_མ་འོངས་པ།_ཐ་དད་པ+བསྐྱོར_འདས་པ།_ཐ་དད་པ+སྐྱོར_འདས་པ།_ཐ་དད་པ+བསྐྱར_མ་འོངས་པ།_ཐ་དད་པ+བསྐྱར_འདས་པ།_ཐ་དད་པ
བསྐྱལ | སྐྱེལ_མ་འོངས་པ།_ཐ་དད་པ+སྐྱེལ_འདས་པ།_###+བསྐྱལ_འདས་པ།_ཐ་དད་པ+སྐྱེལ_མ་འོངས་པ།_###+སྐྱེལ_འདས་པ།_ཐ་དད་པ+བསྐྱལ_མ་འོངས་པ།_ཐ་དད་པ
བསྐྱས | སྐྱ_འདས་པ།_ཐ་དད་པ
བསྐྱི | སྐྱི_མ་འོངས་པ།_ཐ་དད་པ
བསྐྱིལ | བསྐྱིལ_འདས་པ།_ཐ་དད་པ+སྐྱིལ_མ་འོངས་པ།_ཐ་དད་པ+སྐྱིལ_མ་འོངས་པ།_###+སྐྱིལ_འདས་པ།_###+སྐྱིལ_འདས་པ།_ཐ་དད་པ+བསྐྱིལ_མ་འོངས་པ།_ཐ་དད་པ
བསྐྱིས | སྐྱི_འདས་པ།_ཐ་དད་པ
བསྐྱུག | སྐྱུག_མ་འོངས་པ།_ཐ་དད་པ
བསྐྱུགས | སྐྱུག_འདས་པ།_ཐ་དད་པ
བསྐྱུང | སྐྱུང_མ་འོངས་པ།_ཐ་དད་པ
བསྐྱུངས | སྐྱུང_འདས་པ།_ཐ་དད་པ
བསྐྱུད | སྐྱུད_མ་འོངས་པ།_ཐ་དད་པ+བསྐྱུད_འདས་པ།_ཐ་དད་པ+སྐྱུད_འདས་པ།_ཐ་དད་པ+བསྐྱུད_མ་འོངས་པ།_ཐ་དད་པ
བསྐྱུར | སྐྱུར_འདས་པ།_###+བསྐྱུར_མ་འོངས་པ།_ཐ་དད་པ+སྐྱུར_མ་འོངས་པ།_ཐ་དད་པ+བསྐྱུར_འདས་པ།_ཐ་དད་པ+སྐྱུར_འདས་པ།_ཐ་དད་པ+སྐྱུར_མ་འོངས་པ།_###
བསྐྱེད | བསྐྱེད_མ་འོངས་པ།_ཐ་དད་པ+སྐྱེད_མ་འོངས་པ།_ཐ་དད་པ+སྐྱེད_མ་འོངས་པ།_###+བསྐྱེད_འདས་པ།_ཐ་དད་པ+སྐྱེད_འདས་པ།_###+སྐྱེད_འདས་པ།_ཐ་དད་པ
བསྐྱོག | སྐྱོག_མ་འོངས་པ།_###+སྐྱོག_མ་འོངས་པ།_ཐ་དད་པ
བསྐྱོགས | སྐྱོག_འདས་པ།_ཐ་དད་པ+སྐྱོག_འདས་པ།_###
བསྐྱོད | སྐྱོད_འདས་པ།_###+སྐྱོད_མ་འོངས་པ།_###+སྐྱོད_འདས་པ།_ཐ་དད་པ+བསྐྱོད_མ་འོངས་པ།_ཐ་དད་པ+སྐྱོད_མ་འོངས་པ།_ཐ་དད་པ+བསྐྱོད_འདས་པ།_ཐ་དད་པ
བསྐྱོན | བསྐྱོན_མ་འོངས་པ།_ཐ་དད་པ+སྐྱོན_མ་འོངས་པ།_###+སྐྱོན_འདས་པ།_ཐ་དད་པ+བསྐྱོན_འདས་པ།_ཐ་དད་པ+སྐྱོན_འདས་པ།_###+སྐྱོན_མ་འོངས་པ།_ཐ་དད་པ
བསྐྱོམ | སྐྱོམ_མ་འོངས་པ།_###
བསྐྱོམས | སྐྱོམ_འདས་པ།_###
བསྐྱོར | བསྐྱོར_འདས་པ།_###+སྐྱོར_མ་འོངས་པ།_###+བསྐྱོར_མ་འོངས་པ།_###+སྐྱོར_འདས་པ།_###
བསྐྲད | བསྐྲད_འདས་པ།_ཐ་དད་པ+བསྐྲད_མ་འོངས་པ།_ཐ་དད་པ+སྐྲོད_འདས་པ།_ཐ་དད་པ+སྐྲོད_མ་འོངས་པ།_ཐ་དད་པ
བསྐྲུ | སྐྲུ_མ་འོངས་པ།_ཐ་དད་པ+སྐྲུ_མ་འོངས་པ།_###
བསྐྲུན | བསྐྲུན_འདས་པ།_ཐ་དད་པ+སྐྲུན_མ་འོངས་པ།_ཐ་དད་པ+བསྐྲུན_མ་འོངས་པ།_ཐ་དད་པ+སྐྲུན_འདས་པ།_ཐ་དད་པ
བསྐྲུས | སྐྲུ_འདས་པ།_ཐ་དད་པ+སྐྲུ_འདས་པ།_###
བསྐྲོག | སྐྲོག_མ་འོངས་པ།_###+སྐྲོག_མ་འོངས་པ།_ཐ་དད་པ
བསྐྲོགས | སྐྲོག_འདས་པ།_###+སྐྲོག_འདས་པ།_ཐ་དད་པ
བསྒག | སྒོག_མ་འོངས་པ།_ཐ་དད་པ+སྒོག_མ་འོངས་པ།_###
བསྒགས | སྒོག_འདས་པ།_ཐ་དད་པ+སྒོག_འདས་པ།_###
བསྒབ | སྒབ_མ་འོངས་པ།_ཐ་དད་པ
བསྒབས | སྒབ_འདས་པ།_ཐ་དད་པ
བསྒར | སྒོར_འདས་པ།_ཐ་དད་པ+བསྒར_འདས་པ།_###+བསྒར_མ་འོངས་པ།_ཐ་དད་པ+སྒོར_མ་འོངས་པ།_ཐ་དད་པ+བསྒར_མ་འོངས་པ།_###+སྒར_མ་འོངས་པ།_ཐ་དད་པ+བསྒར_འདས་པ།_ཐ་དད་པ+སྒར_འདས་པ།_ཐ་དད་པ
བསྒུག | སྒུགས_མ་འོངས་པ།_ཐ་དད་པ+སྒུག_མ་འོངས་པ།_ཐ་དད་པ
བསྒུགས | སྒུགས_འདས་པ།_ཐ་དད་པ+སྒུག_འདས་པ།_ཐ་དད་པ
བསྒུར | སྒུར_མ་འོངས་པ།_ཐ་མི་དད་པ+བསྒུར_འདས་པ།_ཐ་དད་པ+བསྒུར_མ་འོངས་པ།_ཐ་དད་པ+སྒུར_འདས་པ།_ཐ་མི་དད་པ
བསྒུལ | སྒུལ_མ་འོངས་པ།_ཐ་དད་པ+སྒུལ_འདས་པ།_ཐ་དད་པ+བསྒུལ_འདས་པ།_ཐ་དད་པ+བསྒུལ_མ་འོངས་པ།_ཐ་དད་པ
བསྒོ | བསྒོས_མ་འོངས་པ།_ཐ་དད་པ+སྒོ_མ་འོངས་པ།_###+སྒོ_མ་འོངས་པ།_ཐ་དད་པ
བསྒོང | སྒོང_མ་འོངས་པ།_ཐ་དད་པ+བསྒང_འབྲི་ཚུལ+བྱ་ཚིག_###
བསྒོངས | སྒོང_འདས་པ།_ཐ་དད་པ+སྒོང_འདས་པ།_འབྲི་ཚུལ
བསྒོམ | སྒོམ_མ་འོངས་པ།_ཐ་དད་པ
བསྒོམས | སྒོམ_འདས་པ།_ཐ་དད་པ
བསྒོས | སྒོ_འདས་པ།_###+བསྒོས_འདས་པ།_ཐ་དད་པ+སྒོ_འདས་པ།_ཐ་དད་པ
བསྒྱང | སྒྱང_མ་འོངས་པ།_ཐ་དད་པ
བསྒྱངས | སྒྱང_འདས་པ།_ཐ་དད་པ
བསྒྱིང | སྒྱིང_མ་འོངས་པ།_###+སྒྱིང_མ་འོངས་པ།_ཐ་དད་པ
བསྒྱིངས | སྒྱིང_འདས་པ།_###+སྒྱིང_འདས་པ།_ཐ་དད་པ
བསྒྱུར | སྒྱུར_མ་འོངས་པ།_ཐ་དད་པ+སྒྱུར_མ་འོངས་པ།_###+བསྒྱུར_འདས་པ།_ཐ་དད་པ+བསྒྱུར_མ་འོངས་པ།_ཐ་དད་པ+སྒྱུར_འདས་པ།_ཐ་དད་པ+སྒྱུར_འདས་པ།_###
བསྒྱེལ | བསྒྱེལ_མ་འོངས་པ།_ཐ་དད་པ+སྒྱེལ_མ་འོངས་པ།_ཐ་དད་པ+བསྒྱེལ_འདས་པ།_ཐ་དད་པ+སྒྱེལ_འདས་པ།_ཐ་དད་པ
བསྒྲག | སྒྲོག_མ་འོངས་པ།_ཐ་དད་པ+སྒྲོག_མ་འོངས་པ།_###
བསྒྲགས | སྒྲོག_འདས་པ།_ཐ་དད་པ+སྒྲོག_འདས་པ།_###
བསྒྲང | སྒྲང_མ་འོངས་པ།_ཐ་དད་པ
བསྒྲངས | སྒྲང_འདས་པ།_ཐ་དད་པ
བསྒྲད | བྱ་ཚིག_ཐ་མི་དད་པ+བགྲད_འབྲི་ཚུལ
བསྒྲལ | བསྒྲལ_འདས་པ།_ཐ་དད་པ+བསྒྲལ_མ་འོངས་པ།_ཐ་དད་པ+སྒྲོལ_འདས་པ།_###+སྒྲོལ_མ་འོངས་པ།_ཐ་དད་པ+སྒྲོལ_མ་འོངས་པ།_###+སྒྲོལ_འདས་པ།_ཐ་དད་པ
བསྒྲིག | སྒྲིག_མ་འོངས་པ།_ཐ་དད་པ
བསྒྲིགས | སྒྲིག_འདས་པ།_ཐ་དད་པ
བསྒྲིན | སྒྲིན_མ་འོངས་པ།_ཐ་དད་པ+སྒྲིན_འདས་པ།_ཐ་དད་པ+བསྒྲིན_མ་འོངས་པ།_ཐ་དད་པ+བསྒྲིན_འདས་པ།_ཐ་དད་པ
བསྒྲིབ | སྒྲིབ_མ་འོངས་པ།_ཐ་དད་པ
བསྒྲིབས | སྒྲིབ_འདས་པ།_ཐ་དད་པ
བསྒྲིམ | སྒྲིམ_མ་འོངས་པ།_ཐ་དད་པ
བསྒྲིམས | སྒྲིམ_འདས་པ།_ཐ་དད་པ
བསྒྲིལ | སྒྲིལ_འདས་པ།_###+བསྒྲིལ_འདས་པ།_ཐ་དད་པ+སྒྲིལ_མ་འོངས་པ།_###+བསྒྲིལ_མ་འོངས་པ།_ཐ་དད་པ+སྒྲིལ_འདས་པ།_ཐ་དད་པ+སྒྲིལ_མ་འོངས་པ།_ཐ་དད་པ
བསྒྲུག | སྒྲུག_མ་འོངས་པ།_ཐ་དད་པ+སྒྲུག_མ་འོངས་པ།_###
བསྒྲུགས | སྒྲུག_འདས་པ།_ཐ་དད་པ+སྒྲུག_འདས་པ།_###
བསྒྲུང | སྒྲུངས_མ་འོངས་པ།_ཐ་དད་པ+སྒྲུང_མ་འོངས་པ།_ཐ་དད་པ
བསྒྲུངས | སྒྲུངས_འདས་པ།_ཐ་དད་པ+སྒྲུང_འདས་པ།_ཐ་དད་པ
བསྒྲུན | བསྒྲུན_འདས་པ།_ཐ་དད་པ+སྒྲུན_མ་འོངས་པ།_ཐ་དད་པ+བསྒྲུན_མ་འོངས་པ།_ཐ་དད་པ+སྒྲུན_འདས་པ།_ཐ་དད་པ
བསྒྲུབ | སྒྲུབ_མ་འོངས་པ།_###+སྒྲུབ_མ་འོངས་པ།_ཐ་དད་པ
བསྒྲུབས | སྒྲུབ_འདས་པ།_ཐ་དད་པ+སྒྲུབ_འདས་པ།_###
བསྒྲེ | སྒྲེ_མ་འོངས་པ།_ཐ་དད་པ+སྒྲེ_མ་འོངས་པ།_###+བསྒྲེས_མ་འོངས་པ།_ཐ་དད་པ
བསྒྲེང | སྒྲེང_མ་འོངས་པ།_ཐ་དད་པ
བསྒྲེངས | སྒྲེང_འདས་པ།_ཐ་དད་པ
བསྒྲེས | སྒྲེ_འདས་པ།_ཐ་དད་པ+སྒྲེ_འདས་པ།_###+བསྒྲེས_འདས་པ།_ཐ་དད་པ
བསྒྲོ | སྒྲོ_མ་འོངས་པ།_ཐ་དད་པ
བསྒྲོག | སྒྲོག_མ་འོངས་པ།_འབྲི་ཚུལ
བསྒྲོགས | སྒྲོག_འདས་པ།_འབྲི་ཚུལ
བསྒྲོད | སྒྲོད_འདས་པ།_ཐ་དད་པ+སྒྲོད_མ་འོངས་པ།_ཐ་དད་པ
བསྒྲོན | སྒྲོན_འདས་པ།_###+བསྒྲོན_མ་འོངས་པ།_ཐ་དད་པ+སྒྲོན_མ་འོངས་པ།_###+བསྒྲོན_འདས་པ།_ཐ་དད་པ+སྒྲོན_མ་འོངས་པ།_ཐ་དད་པ+སྒྲོན_འདས་པ།_ཐ་དད་པ
བསྒྲོས | སྒྲོ_འདས་པ།_ཐ་དད་པ
བསྔག | བྱ་ཚིག_ཐ་དད་པ
བསྔགས | གཟུགས་མི་འགྱུར་བ_ཐ་དད་པ
བསྔང | སྔངས_མ་འོངས་པ།_ཐ་མི་དད་པ
བསྔངས | སྔངས_འདས་པ།_ཐ་མི་དད་པ
བསྔས | གཟུགས་མི་འགྱུར་བ_ཐ་མི་དད་པ
བསྔོ | སྔོ_མ་འོངས་པ།_ཐ་དད་པ+བསྔོས_མ་འོངས་པ།_ཐ་དད་པ
བསྔོག | སྔོག_མ་འོངས་པ།_ཐ་དད་པ+སྔོག_མ་འོངས་པ།_###
བསྔོགས | སྔོག_འདས་པ།_ཐ་དད་པ+སྔོག_འདས་པ།_###
བསྔོས | བསྔོས_འདས་པ།_ཐ་དད་པ+སྔོ_འདས་པ།_ཐ་དད་པ
བསྙག | སྙོག_མ་འོངས་པ།_###
བསྙགས | སྙོག_འདས་པ།_###
བསྙད | སྙད_འདས་པ།_ཐ་དད་པ+སྙོད_མ་འོངས་པ།_ཐ་དད་པ+སྙད_མ་འོངས་པ།_ཐ་དད་པ+སྙོད_འདས་པ།_ཐ་དད་པ+བསྙད_མ་འོངས་པ།_ཐ་དད་པ+བསྙད_འདས་པ།_ཐ་དད་པ
བསྙབ | སྙོབ_མ་འོངས་པ།_ཐ་དད་པ
བསྙབས | སྙོབ_འདས་པ།_ཐ་དད་པ
བསྙམ | སྙོམ_མ་འོངས་པ།_ཐ་དད་པ
བསྙམས | སྙོམ_འདས་པ།_ཐ་དད་པ
བསྙལ | སྙལ_མ་འོངས་པ།_###+བསྙལ_འདས་པ།_ཐ་དད་པ+བསྙལ_མ་འོངས་པ།_ཐ་དད་པ+སྙལ_འདས་པ།_ཐ་དད་པ+སྙལ_འདས་པ།_###+སྙལ_མ་འོངས་པ།_ཐ་དད་པ
བསྙིག | སྙིག_མ་འོངས་པ།_ཐ་དད་པ
བསྙིགས | སྙིག_འདས་པ།_ཐ་དད་པ
བསྙིལ | སྙིལ_འདས་པ།_ཐ་དད་པ+སྙིལ_མ་འོངས་པ།_###+བསྙིལ_མ་འོངས་པ།_ཐ་དད་པ+བསྙིལ_འདས་པ།_ཐ་དད་པ+སྙིལ_འདས་པ།_###+སྙིལ_མ་འོངས་པ།_ཐ་དད་པ
བསྙུག | སྙུག_མ་འོངས་པ།_ཐ་དད་པ
བསྙུགས | སྙུག_འདས་པ།_ཐ་དད་པ
བསྙུང | སྙུང_མ་འོངས་པ།_ཐ་མི་དད་པ+སྙུང_མ་འོངས་པ།_ཐ་དད་པ
བསྙུངས | སྙུང_འདས་པ།_ཐ་དད་པ+སྙུང_འདས་པ།_ཐ་མི་དད་པ
བསྙུན | སྙུན_མ་འོངས་པ།_ཐ་མི་དད་པ+བསྙུན_འདས་པ།_ཐ་དད་པ+བསྙུན_མ་འོངས་པ།_ཐ་དད་པ+སྙུན_འདས་པ།_ཐ་མི་དད་པ
བསྙུལ | སྙུལ_མ་འོངས་པ།_ཐ་དད་པ+སྙུལ_འདས་པ།_ཐ་དད་པ+བསྙུལ_མ་འོངས་པ།_ཐ་དད་པ+བསྙུལ_འདས་པ།_ཐ་དད་པ
བསྙེ | སྙེ_མ་འོངས་པ།_ཐ་དད་པ
བསྙེག | སྙེག_མ་འོངས་པ།_ཐ་དད་པ+སྙེག_མ་འོངས་པ།_###
བསྙེགས | སྙེག_འདས་པ།_###+སྙེག_འདས་པ།_ཐ་དད་པ
བསྙེང | སྙེང_མ་འོངས་པ།_ཐ་དད་པ+སྙེང_མ་འོངས་པ།_###+སྙེང_མ་འོངས་པ།_ཐ་མི་དད་པ
བསྙེངས | སྙེང_འདས་པ།_###+སྙེང_འདས་པ།_ཐ་དད་པ+སྙེང_འདས་པ།_ཐ་མི་དད་པ
བསྙེན | བསྙེན_མ་འོངས་པ།_ཐ་དད་པ+སྙེན_འདས་པ།_ཐ་དད་པ+སྙེན_མ་འོངས་པ།_ཐ་དད་པ+བསྙེན_འདས་པ།_ཐ་དད་པ
བསྙེམ | སྙེམ_མ་འོངས་པ།_ཐ་དད་པ
བསྙེམས | སྙེམ_འདས་པ།_ཐ་དད་པ
བསྙེར | བསྙེར_མ་འོངས་པ།_ཐ་དད་པ+བསྙེར_འདས་པ།_ཐ་དད་པ+སྙེར_མ་འོངས་པ།_ཐ་དད་པ+སྙེར_འདས་པ།_ཐ་དད་པ
བསྙེལ | སྙེལ_མ་འོངས་པ།_ཐ་དད་པ+སྙེལ_འདས་པ།_ཐ་དད་པ+བསྙེལ_མ་འོངས་པ།_ཐ་དད་པ+བསྙེལ_འདས་པ།_ཐ་དད་པ
བསྙེས | སྙེ_འདས་པ།_ཐ་དད་པ
བསྙོག | སྙོག_མ་འོངས་པ།_ཐ་དད་པ
བསྙོགས | སྙོག_འདས་པ།_ཐ་དད་པ
བསྙོད | བསྙོད_མ་འོངས་པ།_ཐ་དད་པ+སྙོད_མ་འོངས་པ།_###+བསྙོད_འདས་པ།_ཐ་དད་པ+སྙོད_འདས་པ།_###
བསྙོན | སྙོན_མ་འོངས་པ།_ཐ་དད་པ+བསྙོན_འདས་པ།_ཐ་དད་པ+བསྙོན_མ་འོངས་པ།_ཐ་དད་པ+སྙོན_འདས་པ།_ཐ་དད་པ
བསྙོར | སྙོར_འདས་པ།_ཐ་དད་པ+སྙོར_མ་འོངས་པ།_ཐ་དད་པ+བསྙོར_མ་འོངས་པ།_ཐ་དད་པ+བསྙོར_འདས་པ།_ཐ་དད་པ
བསྙོལ | སྙལ_འདསཔ_འབྲི་ཚུལ+བྱ་ཚིག_ཐ་དད་པ
བསྟང | སྟང_མ་འོངས་པ།_ཐ་དད་པ
བསྟངས | སྟང_འདས་པ།_ཐ་དད་པ
བསྟད | སྟོད_མ་འོངས་པ།_ཐ་དད་པ+བསྟད_འདས་པ།_ཐ་དད་པ+བསྟད_མ་འོངས་པ།_ཐ་དད་པ+སྟོད_འདས་པ།_ཐ་དད་པ+སྟོད_འདས་པ།_###+སྟོད_མ་འོངས་པ།_###
བསྟན | སྟོན_འདས་པ།_ཐ་དད་པ+སྟོན_མ་འོངས་པ།_ཐ་དད་པ
བསྟབ | སྟོབ_མ་འོངས་པ།_ཐ་དད་པ
བསྟབས | སྟོབ_འདས་པ།_ཐ་དད་པ
བསྟར | བསྟར_མ་འོངས་པ།_ཐ་དད་པ+བསྟར_འདས་པ།_###+བསྟར_མ་འོངས་པ།_###+སྟར_འདས་པ།_ཐ་དད་པ+སྟར_མ་འོངས་པ།_ཐ་དད་པ+སྟོར_མ་འོངས་པ།_###+སྟར_འདས་པ།_###+སྟོར_མ་འོངས་པ།_ཐ་དད་པ+སྟོར_འདས་པ།_###+བསྟར_འདས་པ།_ཐ་དད་པ+སྟོར_འདས་པ།_ཐ་དད་པ+སྟར_མ་འོངས་པ།_###
བསྟི | སྟི_མ་འོངས་པ།_ཐ་མི་དད་པ+སྟིས_མ་འོངས་པ།_ཐ་མི་དད་པ
བསྟིང | སྟིང_མ་འོངས་པ།_ཐ་དད་པ
བསྟིངས | སྟིང_འདས་པ།_ཐ་དད་པ
བསྟིམ | སྟིམ_མ་འོངས་པ།_###+སྟིམ_མ་འོངས་པ།_ཐ་དད་པ
བསྟིམས | སྟིམ_འདས་པ།_ཐ་དད་པ+སྟིམ_འདས་པ།_###
བསྟིས | སྟི_འདས་པ།_ཐ་མི་དད་པ+སྟིས_འདས་པ།_ཐ་མི་དད་པ
བསྟུང | སྟུང_མ་འོངས་པ།_ཐ་མི་དད་པ+སྟུང_མ་འོངས་པ།_###
བསྟུངས | སྟུང_འདས་པ།_ཐ་མི་དད་པ+སྟུང_འདས་པ།_###
བསྟུད | སྟུད_འདས་པ།_ཐ་དད་པ+སྟུད_མ་འོངས་པ།_ཐ་དད་པ+བསྟུད_མ་འོངས་པ།_ཐ་དད་པ+བསྟུད_འདས་པ།_ཐ་དད་པ
བསྟུན | སྟུན_འདས་པ།_ཐ་དད་པ+སྟུན_མ་འོངས་པ།_ཐ་དད་པ+བསྟུན_མ་འོངས་པ།_ཐ་དད་པ+བསྟུན_འདས་པ།_ཐ་དད་པ
བསྟེན | སྟེན_འདས་པ།_ཐ་དད་པ+སྟེན_འདས་པ།_###+སྟེན_མ་འོངས་པ།_###+བསྟེན_མ་འོངས་པ།_ཐ་དད་པ+བསྟེན_འདས་པ།_ཐ་དད་པ+སྟེན_མ་འོངས་པ།_ཐ་དད་པ
བསྟོང | སྟོང_མའོངསཔ_འབྲི་ཚུལ+བྱ་ཚིག_ཐ་དད་པ
བསྟོངས | སྟོང_འདསཔ_འབྲི་ཚུལ+བྱ་ཚིག_ཐ་དད་པ
བསྟོད | གཟུགས་མི་འགྱུར་བ_ཐ་དད་པ
བསྡད | སྡོད_འདས་པ།_ཐ་མི་དད་པ+བསྡད_མ་འོངས་པ།_ཐ་མི་དད་པ+སྡོད_མ་འོངས་པ།_ཐ་མི་དད་པ+བསྡད_འདས་པ།_ཐ་མི་དད་པ+སྡོད_མ་འོངས་པ།_###+སྡོད_འདས་པ།_###
བསྡམ | སྡོམ_མ་འོངས་པ།_ཐ་དད་པ+སྡོམ_མ་འོངས་པ།_###
བསྡམས | སྡོམ_འདས་པ།_###+སྡོམ_འདས་པ།_ཐ་དད་པ
བསྡིག | སྡིག_མ་འོངས་པ།_ཐ་དད་པ+སྡིག_མ་འོངས་པ།_###
བསྡིགས | སྡིག_འདས་པ།_###+སྡིག_འདས་པ།_ཐ་དད་པ
བསྡུ | སྡུད_མ་འོངས་པ།_ཐ་དད་པ+སྡུད_མ་འོངས་པ།_###
བསྡུམ | སྡུམ_མ་འོངས་པ།_ཐ་དད་པ
བསྡུམས | སྡུམ_འདས་པ།_ཐ་དད་པ
བསྡུར | སྡུར_མ་འོངས་པ།_ཐ་དད་པ+བསྡུར_འདས་པ།_ཐ་དད་པ+བསྡུར_མ་འོངས་པ།_ཐ་དད་པ+སྡུར_འདས་པ།_ཐ་དད་པ
བསྡུས | སྡུད_འདས་པ།_###+སྡུད_འདས་པ།_ཐ་དད་པ
བསྡེབ | སྡེབ_མ་འོངས་པ།_ཐ་དད་པ
བསྡེབས | སྡེབ_འདས་པ།_ཐ་དད་པ
བསྡོ | སྡོ_མ་འོངས་པ།_###+སྡོ_མ་འོངས་པ།_ཐ་དད་པ
བསྡོག | སྡོག_མ་འོངས་པ།_###+སྡོག_མ་འོངས་པ།_ཐ་དད་པ
བསྡོགས | སྡོག_འདས་པ།_###+སྡོག_འདས་པ།_ཐ་དད་པ
བསྡོང | སྡོང_མ་འོངས་པ།_ཐ་མི་དད་པ
བསྡོངས | སྡོང_འདས་པ།_ཐ་མི་དད་པ
བསྡོམ | སྡོམ_མ་འོངས་པ།_###
བསྡོམས | སྡོམ_འདས་པ།_###
བསྡོས | སྡོ_འདས་པ།_ཐ་དད་པ+སྡོ_འདས་པ།_###
བསྣད | བསྣད_མ་འོངས་པ།_ཐ་དད་པ+སྣད_མ་འོངས་པ།_ཐ་དད་པ+སྣད_འདས་པ།_ཐ་དད་པ+བསྣད_འདས་པ།_ཐ་དད་པ
བསྣན | བསྣན_མ་འོངས་པ།_ཐ་དད་པ+སྣོན_མ་འོངས་པ།_###+སྣོན_མ་འོངས་པ།_ཐ་དད་པ+སྣོན_འདས་པ།_###+སྣོན_འདས་པ།_ཐ་དད་པ+བསྣན_འདས་པ།_ཐ་དད་པ
བསྣམ | སྣོམ_མ་འོངས་པ།_###+སྣོམ_མ་འོངས་པ།_ཐ་དད་པ+སྣོམས_མ་འོངས་པ།_ཐ་དད་པ
བསྣམས | སྣོམ_འདས་པ།_ཐ་དད་པ+སྣོམ_འདས་པ།_###+སྣོམས_འདས་པ།_ཐ་དད་པ
བསྣར | སྣར_མ་འོངས་པ།_ཐ་དད་པ+སྣར_འདས་པ།_ཐ་དད་པ+སྣར_འདས་པ།_###+སྣར_མ་འོངས་པ།_###+བསྣར_མ་འོངས་པ།_ཐ་དད་པ+བསྣར_འདས་པ།_ཐ་དད་པ
བསྣུད | སྣུད_མ་འོངས་པ།_ཐ་དད་པ+བསྣུད_མ་འོངས་པ།_ཐ་དད་པ+བསྣུད_འདས་པ།_ཐ་དད་པ+སྣུད_འདས་པ།_ཐ་དད་པ
བསྣུན | སྣུན_འདས་པ།_###+བསྣུན_མ་འོངས་པ།_ཐ་དད་པ+སྣུན_འདས་པ།_ཐ་དད་པ+སྣུན_མ་འོངས་པ།_###+བསྣུན_འདས་པ།_ཐ་དད་པ+སྣུན_མ་འོངས་པ།_ཐ་དད་པ
བསྣུབ | སྣུབ_མ་འོངས་པ།_ཐ་དད་པ
བསྣུབས | སྣུབ_འདས་པ།_ཐ་དད་པ
བསྣུར | བསྣུར_མ་འོངས་པ།_ཐ་དད་པ+སྣུར_མ་འོངས་པ།_ཐ་མི་དད་པ+སྣུར_འདས་པ།_###+སྣུར_མ་འོངས་པ།_ཐ་དད་པ+སྣུར_འདས་པ།_ཐ་དད་པ+སྣུར_མ་འོངས་པ།_###+བསྣུར_འདས་པ།_ཐ་དད་པ+སྣུར_འདས་པ།_ཐ་མི་དད་པ
བསྣེམ | སྣེམ_མ་འོངས་པ།_ཐ་དད་པ+སྣེམ_མ་འོངས་པ།_###
བསྣེམས | སྣེམ_འདས་པ།_ཐ་དད་པ+སྣེམ_འདས་པ།_###
བསྣོ | སྣོ_མ་འོངས་པ།_ཐ་དད་པ
བསྣོག | སྣོགས_མ་འོངས་པ།_ཐ་དད་པ+སྣོག_མ་འོངས་པ།_###+སྣོག_མ་འོངས་པ།_ཐ་དད་པ
བསྣོགས | སྣོགས_འདས་པ།_ཐ་དད་པ+སྣོག_འདས་པ།_###+སྣོག_འདས་པ།_ཐ་དད་པ
བསྣོར | སྣོར_མ་འོངས་པ།_ཐ་དད་པ+སྣོར_འདས་པ།_ཐ་དད་པ+བསྣོར_མ་འོངས་པ།_ཐ་དད་པ+བསྣོར_འདས་པ།_ཐ་དད་པ
བསྣོལ | སྣོལ_འདས་པ།_ཐ་དད་པ+བསྣོལ_འདས་པ།_ཐ་དད་པ+སྣོལ_མ་འོངས་པ།_ཐ་དད་པ+བསྣོལ_མ་འོངས་པ།_ཐ་དད་པ
བསྣོས | སྣོ_འདས་པ།_ཐ་དད་པ
བསྩགས | བསགས_འབྲི་ཚུལ+བྱ་ཚིག_ཐ་དད་པ
བསྩལ | བསྩལ_མ་འོངས་པ།_ཐ་དད་པ+སྩོལ_མ་འོངས་པ།_ཐ་དད་པ+སྩོལ_འདས་པ།_ཐ་དད་པ+བསྩལ_འདས་པ།_ཐ་དད་པ
བསྲང | སྲོང_མ་འོངས་པ།_ཐ་དད་པ+སྲོང_མ་འོངས་པ།_###
བསྲངས | སྲོང_འདས་པ།_ཐ་དད་པ+སྲོང_འདས་པ།_###
བསྲད | སྲད_མ་འོངས་པ།_ཐ་མི་དད་པ+སྲད_འདས་པ།_ཐ་མི་དད་པ+བསྲད_མ་འོངས་པ།_ཐ་དད་པ+བསྲད_འདས་པ།_ཐ་དད་པ
བསྲན | སྲན_མ་འོངས་པ།_ཐ་དད་པ+སྲན_འདས་པ།_ཐ་དད་པ+བསྲན_མ་འོངས་པ།_ཐ་དད་པ+བསྲན_འདས་པ།_ཐ་དད་པ
བསྲབ | སྲབ_མ་འོངས་པ།_ཐ་མི་དད་པ
བསྲབས | སྲབ_འདས་པ།_ཐ་མི་དད་པ
བསྲི | སྲི_མ་འོངས་པ།_ཐ་དད་པ
བསྲིང | སྲིང_མ་འོངས་པ།_###+སྲིང_མ་འོངས་པ།_ཐ་དད་པ
བསྲིངས | སྲིང_འདས་པ།_###+སྲིང_འདས་པ།_ཐ་དད་པ
བསྲིབ | བསྲིབས_མ་འོངས་པ།_ཐ་དད་པ+སྲིབ_མ་འོངས་པ།_ཐ་དད་པ
བསྲིབས | བསྲིབས_འདས་པ།_ཐ་དད་པ+སྲིབ_འདས་པ།_ཐ་དད་པ
བསྲིས | སྲི_འདས་པ།_ཐ་དད་པ
བསྲུང | སྲུང_མ་འོངས་པ།_ཐ་དད་པ+སྲུང_མ་འོངས་པ།_###
བསྲུངས | སྲུང_འདས་པ།_ཐ་དད་པ+སྲུང_འདས་པ།_###
བསྲུན | བསྲུན_མ་འོངས་པ།_ཐ་དད་པ+བསྲུན_འདས་པ།_ཐ་དད་པ+སྲུན_མ་འོངས་པ།_ཐ་དད་པ+སྲུན_འདས་པ།_ཐ་དད་པ
བསྲུབ | སྲུབ_མ་འོངས་པ།_###+སྲུབ_མ་འོངས་པ།_ཐ་དད་པ
བསྲུབས | སྲུབ_འདས་པ།_ཐ་དད་པ+སྲུབ_འདས་པ།_###
བསྲུལ | བསྲུལ_འདས་པ།_ཐ་དད་པ+བསྲུལ_མ་འོངས་པ།_ཐ་དད་པ+སྲུལ_འདས་པ།_ཐ་དད་པ+སྲུལ_མ་འོངས་པ།_ཐ་དད་པ
བསྲེ | སྲེ_མ་འོངས་པ།_ཐ་དད་པ
བསྲེག | སྲེག_མ་འོངས་པ།_###+སྲེག_མ་འོངས་པ།_ཐ་དད་པ
བསྲེགས | སྲེག_འདས་པ།_###+སྲེག_འདས་པ།_ཐ་དད་པ
བསྲེལ | བསྲེལ_འདས་པ།_ཐ་དད་པ+སྲེལ_འདས་པ།_ཐ་དད་པ+སྲེལ_མ་འོངས་པ།_ཐ་དད་པ+བསྲེལ_མ་འོངས་པ།_ཐ་དད་པ
བསྲེས | སྲེ_འདས་པ།_ཐ་དད་པ
བསྲོ | སྲོ_མ་འོངས་པ།_ཐ་དད་པ
བསྲོས | སྲོ_འདས་པ།_ཐ་དད་པ
བསླ | སླ_མ་འོངས་པ།_འབྲི་ཚུལ
བསླང | སློང_མ་འོངས་པ།_ཐ་དད་པ+སློང_མ་འོངས་པ།_###
བསླངས | སློང_འདས་པ།_ཐ་དད་པ+སློང_འདས་པ།_###
བསླད | སློད_འདས་པ།_###+བསླད_མ་འོངས་པ།_ཐ་དད་པ+སློད_མ་འོངས་པ།_###+བསླད_འདས་པ།_ཐ་དད་པ+སློད_འདས་པ།_ཐ་དད་པ+སློད_མ་འོངས་པ།_ཐ་དད་པ
བསླན | སློན_མ་འོངས་པ།_###+བསླན_འདས་པ།_ཐ་དད་པ+བསླན_མ་འོངས་པ།_ཐ་དད་པ+སློན_འདས་པ།_###+སློན_མ་འོངས་པ།_ཐ་དད་པ+སློན_འདས་པ།_ཐ་དད་པ
བསླབ | སློབ_མ་འོངས་པ།_ཐ་དད་པ
བསླབས | སློབ_འདས་པ།_ཐ་དད་པ
བསླས | སླ_འདས་པ།_འབྲི་ཚུལ
བསླུ | སླུ_མ་འོངས་པ།_ཐ་དད་པ
བསླུས | སླུ_འདས་པ།_ཐ་དད་པ
བསླེ | སླེ_མ་འོངས་པ།_ཐ་དད་པ
བསླེབ | སླེབ_མའོངསཔ_འབྲི་ཚུལ+བྱ་ཚིག_ཐ་མི་དད་པ
བསླེབས | བྱ་ཚིག_###+སླེབས_འབྲི་ཚུལ
བསླེས | སླེ_འདས་པ།_ཐ་དད་པ
བསློག | སློག_མ་འོངས་པ།_ཐ་དད་པ+སློག_མ་འོངས་པ།_###
བསློགས | སློག_འདས་པ།_ཐ་དད་པ+སློག_འདས་པ།_###
བུད | འབུད_སྐུལ་ཚིག_ཐ་མི་དད་པ+བུད_སྐུལ་ཚིག_ཐ་མི་དད་པ+འབུད_འདས་པ།_ཐ་མི་དད་པ+བུད_འདས་པ།_ཐ་མི་དད་པ
བུབ | གཟུགས་མི་འགྱུར་བ_ཐ་མི་དད་པ
བུས | འབུད_འདས་པ།_###+འབུད_འདས་པ།_ཐ་དད་པ+འབུད_སྐུལ་ཚིག_###+བུས_འདས་པ།_ཐ་དད་པ+བུས_སྐུལ་ཚིག_ཐ་དད་པ+འབུད_སྐུལ་ཚིག_ཐ་དད་པ
བེམ | གཟུགས་མི་འགྱུར་བ_ཐ་མི་དད་པ
བོག | འབོགས_འབྲི་ཚུལ+བྱ་ཚིག_ཐ་མི་དད་པ
བོབས | འབབ_སྐུལ་ཚིག_ཐ་མི་དད་པ
བོར | འབོར_འདས་པ།_ཐ་མི་དད་པ+འབོར_སྐུལ་ཚིག_ཐ་མི་དད་པ+བོར_སྐུལ་ཚིག_###+འབོར_འདས་པ།_###+བོར_འདས་པ།_###
བོལ | འབལ_སྐུལ་ཚིག_ཐ་དད་པ
བོས | བོས_སྐུལ་ཚིག_ཐ་དད་པ+བོས_འདས་པ།_ཐ་དད་པ+འབོད_འདས་པ།_###+འབོད_སྐུལ་ཚིག_###
བྱ | བྱེད_མ་འོངས་པ།_ཐ་དད་པ
བྱང | འབྱང_འདས་པ།_ཐ་མི་དད་པ+བྱ་ཚིག_###+གཟུགས་མི་འགྱུར་བ_ཐ་མི་དད་པ+འབྱང_འདས་པ།_###
བྱབ | བྱབ_མ་འོངས་པ།_ཐ་དད་པ+བྱབ_མ་འོངས་པ།_###+བྱབ_ད་ལྟ་བ།_###+བྱབ_ད་ལྟ་བ།_ཐ་དད་པ
བྱབས | བྱབ_འདས་པ།_ཐ་དད་པ+བྱབ_འདས་པ།_###
བྱམས | གཟུགས་མི་འགྱུར་བ_ཐ་མི་དད་པ
བྱས | བྱེད_འདས་པ།_ཐ་དད་པ
བྱི | འབྱི_འདས་པ།_ཐ་མི་དད་པ
བྱིང | འབྱིང_འདས་པ།_ཐ་མི་དད་པ
བྱིངས | འབྱིང_འདས་པ།_###
བྱིད | འབྱིད_འདས་པ།_ཐ་མི་དད་པ+བྱ་ཚིག_###+ཕྱིས_མའོངསཔ_འབྲི་ཚུལ
བྱིན | སྦྱིན_འདས་པ།_ཐ་དད་པ+སྦྱིན_སྐུལ་ཚིག_ཐ་དད་པ+བྱིན_སྐུལ་ཚིག_ཐ་དད་པ+བྱིན_འདས་པ།_ཐ་དད་པ
བྱིབས | འབྱིབ_སྐུལ་ཚིག_ཐ་དད་པ+བྱིབས_འདས་པ།_ཐ་དད་པ+བྱིབས_སྐུལ་ཚིག_ཐ་དད་པ+འབྱིབ_འདས་པ།_ཐ་དད་པ
བྱིལ | འབྱིལ_འདས་པ།_ཐ་མི་དད་པ+གཟུགས་མི་འགྱུར་བ_ཐ་དད་པ
བྱུག | འབྱུག_མ་འོངས་པ།_ཐ་དད་པ+བྱུགས_མ་འོངས་པ།_ཐ་དད་པ
བྱུགས | འབྱུག_འདས་པ།_ཐ་དད་པ+བྱུགས_འདས་པ།_ཐ་དད་པ+གཟུགས་མི་འགྱུར་བ_ཐ་དད་པ+བྱུགས_སྐུལ་ཚིག_ཐ་དད་པ+འབྱུག_སྐུལ་ཚིག_ཐ་དད་པ
བྱུང | འབྱུང_འདས་པ།_ཐ་མི་དད་པ
བྱེ | འབྱེ_འདས་པ།_ཐ་དད་པ
བྱེད | བྱེད_ད་ལྟ་བ།_ཐ་དད་པ
བྱེར | འབྱེར_འདས་པ།_ཐ་མི་དད་པ+བྱེར_སྐུལ་ཚིག_ཐ་མི་དད་པ+བྱེར_འདས་པ།_ཐ་མི་དད་པ+འབྱེར_སྐུལ་ཚིག_ཐ་མི་དད་པ+འབྱེར_འདས་པ།_###
བྱེས | འབྱེ_སྐུལ་ཚིག_ཐ་དད་པ
བྱོ | འབྱོ_འདས་པ།_ཐ་དད་པ+བྱོ_འདས་པ།_ཐ་དད་པ+འབྱོ_སྐུལ་ཚིག_ཐ་དད་པ+བྱོ_སྐུལ་ཚིག_ཐ་དད་པ
བྱོང | འབྱང_སྐུལ་ཚིག_###
བྱོན | བྱོན_འདས་པ།_ཐ་མི་དད་པ+འབྱོན_སྐུལ་ཚིག_ཐ་དད་པ+འབྱོན_འདས་པ།_ཐ་དད་པ+བྱོན_སྐུལ་ཚིག_ཐ་མི་དད་པ
བྱོབས | བྱབ_སྐུལ་ཚིག_###+བྱབ_སྐུལ་ཚིག_ཐ་དད་པ
བྱོལ | འབྱོལ_མ་འོངས་པ།_ཐ་མི་དད་པ+བྱོལ_འདས་པ།_ཐ་མི་དད་པ+བྱོལ_སྐུལ་ཚིག_ཐ་མི་དད་པ+འབྱོལ_སྐུལ་ཚིག_ཐ་མི་དད་པ+བྱོལ_མ་འོངས་པ།_ཐ་མི་དད་པ+འབྱོལ_འདས་པ།_ཐ་མི་དད་པ
བྱོས | བྱེད_སྐུལ་ཚིག_ཐ་དད་པ
བྲད | འབྲད_འདས་པ།_###+འབྲད_འདས་པ།_ཐ་དད་པ
བྲན | འབྲན_འདས་པ།_ཐ་དད་པ+འབྲན_མ་འོངས་པ།_ཐ་དད་པ+བྲན_མ་འོངས་པ།_ཐ་དད་པ+བྲན_འདས་པ།_ཐ་དད་པ
བྲབ | འབྲབ_མ་འོངས་པ།_ཐ་དད་པ
བྲབས | འབྲབ_འདས་པ།_ཐ་དད་པ
བྲལ | འབྲལ_འདས་པ།_ཐ་མི་དད་པ
བྲི | འབྲི_འདས་པ།_ཐ་མི་དད་པ+འབྲི_མ་འོངས་པ།_ཐ་མི་དད་པ
བྲིད | བྲིད_འདས་པ།_ཐ་དད་པ+འབྲིད_འདས་པ།_ཐ་དད་པ+འབྲིད_སྐུལ་ཚིག_ཐ་དད་པ+བྲིད_སྐུལ་ཚིག_ཐ་དད་པ
བྲིན | གཟུགས་མི་འགྱུར་བ_ཐ་མི་དད་པ
བྲིམ | འབྲིམ_མ་འོངས་པ།_ཐ་དད་པ
བྲིམས | འབྲིམ_སྐུལ་ཚིག_ཐ་དད་པ
བྲུ | འབྲུ_མ་འོངས་པ།_###+འབྲུ_མ་འོངས་པ།_ཐ་དད་པ+བྲུས_མ་འོངས་པ།_ཐ་དད་པ
བྲུག | གཟུགས་མི་འགྱུར་བ_ཐ་མི་དད་པ
བྲུབ | འབྲུབ_མའོངསཔ_འབྲི་ཚུལ+བྱ་ཚིག_ཐ་དད་པ
བྲུབས | འབྲུབ_འདས་པ།_ཐ་དད་པ+འབྲུབ_སྐུལ་ཚིག_ཐ་དད་པ
བྲུལ | འབྲུལ_འདས་པ།_ཐ་མི་དད་པ
བྲུས | བྲུས_འདས་པ།_ཐ་དད་པ+འབྲུ_སྐུལ་ཚིག_###+བྲུས_སྐུལ་ཚིག_ཐ་དད་པ+འབྲུ_འདས་པ།_###+འབྲུ_འདས་པ།_ཐ་དད་པ+འབྲུ_སྐུལ་ཚིག_ཐ་དད་པ
བྲེ | བྲེ_མ་འོངས་པ།_ཐ་དད་པ+བྲེ_ད་ལྟ་བ།_ཐ་དད་པ+བྲེས_མ་འོངས་པ།_ཐ་དད་པ+བྲེས_ད་ལྟ་བ།_ཐ་དད་པ
བྲེག | འབྲེག_མ་འོངས་པ།_ཐ་དད་པ
བྲེགས | འབྲེག_འདས་པ།_ཐ་དད་པ
བྲེད | གཟུགས་མི་འགྱུར་བ_ཐ་མི་དད་པ
བྲེས | བྲེས_སྐུལ་ཚིག_ཐ་དད་པ+འབྲ_འདས་པ།_ཐ་དད་པ+འབྲ_སྐུལ་ཚིག_ཐ་དད་པ+བྲེ_སྐུལ་ཚིག_ཐ་དད་པ+བྲེ_འདས་པ།_ཐ་དད་པ+བྲེས_འདས་པ།_ཐ་དད་པ
བྲོ | གཟུགས་མི་འགྱུར་བ_ཐ་མི་དད་པ+བྱ་ཚིག_###
བྲོགས | འབྲེག_སྐུལ་ཚིག_ཐ་དད་པ
བྲོད | གཟུགས་མི་འགྱུར་བ_ཐ་མི་དད་པ
བྲོན | འབྲན_སྐུལ་ཚིག_ཐ་དད་པ+བྲན_སྐུལ་ཚིག_ཐ་དད་པ
བྲོབས | ཕྲོབས_འབྲི་ཚུལ+བྱ་ཚིག_ཐ་དད་པ+འབྲབ_སྐུལ་ཚིག_ཐ་དད་པ
བྲོས | བྲོས_འདས་པ།_ཐ་མི་དད་པ+འབྲོ_སྐུལ་ཚིག_ཐ་མི་དད་པ+འབྲོ_འདས་པ།_ཐ་མི་དད་པ+བྲོས_སྐུལ་ཚིག_ཐ་མི་དད་པ
བླག | བླག_ད་ལྟ་བ།_ཐ་དད་པ+བླག_མ་འོངས་པ།_ཐ་དད་པ
བླགས | བླག_འདས་པ།_ཐ་དད་པ
བླང | ལེན_མ་འོངས་པ།_ཐ་དད་པ+ལེན_མ་འོངས་པ།_###
བླངས | ལེན_འདས་པ།_###+ལེན_འདས་པ།_ཐ་དད་པ
བླད | བློད_འདས་པ།_###+བླད_མ་འོངས་པ།_ཐ་དད་པ+བློད_མ་འོངས་པ།_ཐ་དད་པ+བླད_འདས་པ།_ཐ་དད་པ+བློད_མ་འོངས་པ།_###+བློད_འདས་པ།_ཐ་དད་པ
བླུ | བླུ_མ་འོངས་པ།_ཐ་དད་པ+བླུས_ད་ལྟ་བ།_ཐ་དད་པ+བླུས_མ་འོངས་པ།_ཐ་དད་པ+བླུ_ད་ལྟ་བ།_ཐ་དད་པ
བླུག | བླུགས_ད་ལྟ་བ།_ཐ་དད་པ+བླུག_ད་ལྟ་བ།_ཐ་དད་པ+བླུགས_མ་འོངས་པ།_ཐ་དད་པ+བླུག_མ་འོངས་པ།_ཐ་དད་པ
བླུགས | བླུགས_སྐུལ་ཚིག_ཐ་དད་པ+བླུག_སྐུལ་ཚིག_ཐ་དད་པ+བླུགས_འདས་པ།_ཐ་དད་པ+བླུག_འདས་པ།_ཐ་དད་པ
བླུད | བླུད_འདས་པ།_ཐ་དད་པ+ལྡུད_སྐུལ་ཚིག_ཐ་དད་པ+ལྡུད_འདས་པ།_ཐ་དད་པ+བླུད_སྐུལ་ཚིག_ཐ་དད་པ
བླུས | བླུས_སྐུལ་ཚིག_ཐ་དད་པ+བླུ_འདས་པ།_ཐ་དད་པ+བླུ_སྐུལ་ཚིག_ཐ་དད་པ+བླུས_འདས་པ།_ཐ་དད་པ
བློག | བླག_འབྲི་ཚུལ+བྱ་ཚིག_ཐ་དད་པ
བློགས | བླག_སྐུལ་ཚིག_ཐ་དད་པ
བློད | བློད_ད་ལྟ་བ།_###+བློད_སྐུལ་ཚིག_###+བླད_སྐུལ་ཚིག_ཐ་དད་པ+བློད_སྐུལ་ཚིག_ཐ་དད་པ+བློད_ད་ལྟ་བ།_ཐ་དད་པ+བླད_ད་ལྟ་བ།_ཐ་དད་པ
མཁས | གཟུགས་མི་འགྱུར་བ_ཐ་མི་དད་པ
མཁུ | འཁུ_འབྲི་ཚུལ+བྱ་ཚིག_###
མཁུན | བྱ་ཚིག_###+འཁུན_འབྲི་ཚུལ
མཁོན | འཁོན_འབྲི་ཚུལ+བྱ་ཚིག_ཐ་དད་པ
མཁྱུད | གཟུགས་མི་འགྱུར་བ_ཐ་དད་པ
མཁྱེན | གཟུགས་མི་འགྱུར་བ_ཐ་དད་པ
མགར | མགར_མ་འོངས་པ།_ཐ་དད་པ+མགར_ད་ལྟ་བ།_ཐ་དད་པ+མགར_འདས་པ།_ཐ་དད་པ
མགུ | གཟུགས་མི་འགྱུར་བ_ཐ་མི་དད་པ
མགོར | མགར_སྐུལ་ཚིག_ཐ་དད་པ
མངག | མངག_ད་ལྟ་བ།_ཐ་དད་པ+མངག_མ་འོངས་པ།_ཐ་དད་པ
མངགས | མངག_འདས་པ།_ཐ་དད་པ
མངལ | གཟུགས་མི་འགྱུར་བ_ཐ་མི་དད་པ
མངོགས | མངག_སྐུལ་ཚིག_ཐ་དད་པ
མངོན | གཟུགས་མི་འགྱུར་བ_ཐ་མི་དད་པ
མཆི | མཆི_མ་འོངས་པ།_ཐ་མི་དད་པ+མཆི_ད་ལྟ་བ།_ཐ་མི་དད་པ
མཆིད | གཟུགས་མི་འགྱུར་བ_ཐ་དད་པ
མཆིས | མཆི_འདས་པ།_ཐ་མི་དད་པ
མཆེད | གཟུགས་མི་འགྱུར་བ_ཐ་མི་དད་པ
མཆོང | མཆོངས_མ་འོངས་པ།_ཐ་མི་དད་པ+མཆོངས_ད་ལྟ་བ།_ཐ་མི་དད་པ+མཆོང_ད་ལྟ་བ།_ཐ་མི་དད་པ+མཆོང_མ་འོངས་པ།_ཐ་མི་དད་པ
མཆོངས | མཆོངས_འདས་པ།_ཐ་མི་དད་པ+མཆོང_འདས་པ།_ཐ་མི་དད་པ+མཆོང_སྐུལ་ཚིག_ཐ་མི་དད་པ+མཆོངས_སྐུལ་ཚིག_ཐ་མི་དད་པ
མཆོད | བྱ་ཚིག_###+གཟུགས་མི་འགྱུར་བ_ཐ་དད་པ
མཆོར | གཟུགས་མི་འགྱུར་བ_ཐ་དད་པ
མཇལ | གཟུགས་མི་འགྱུར་བ_ཐ་མི་དད་པ+མཇལ_འདས་པ།_ཐ་དད་པ+མཇལ_ད་ལྟ་བ།_ཐ་དད་པ+མཇལ_མ་འོངས་པ།_ཐ་དད་པ
མཇེད | གཟུགས་མི་འགྱུར་བ_ཐ་མི་དད་པ
མཇོལ | མཇལ_སྐུལ་ཚིག_ཐ་དད་པ
མཉན | ཉན_འདས་པ།_ཐ་དད་པ+མཉན_འདས་པ།_ཐ་དད་པ+མཉན_མ་འོངས་པ།_ཐ་དད་པ+ཉན_མ་འོངས་པ།_ཐ་དད་པ
མཉམ | གཟུགས་མི་འགྱུར་བ_ཐ་མི་དད་པ
མཉེ | མཉེས_མ་འོངས་པ།_ཐ་དད་པ+ཉེད_མ་འོངས་པ།_ཐ་དད་པ
མཉེད | ཉེད_འབྲི་ཚུལ+བྱ་ཚིག_ཐ་དད་པ
མཉེལ | གཟུགས་མི་འགྱུར་བ_ཐ་མི་དད་པ
མཉེས | ཉེད_སྐུལ་ཚིག_ཐ་དད་པ+གཟུགས་མི་འགྱུར་བ_ཐ་མི་དད་པ+ཉེད_འདས་པ།_ཐ་དད་པ+མཉེས_འདས་པ།_ཐ་དད་པ+མཉེས_སྐུལ་ཚིག_ཐ་དད་པ
མཐུད | གཟུགས་མི་འགྱུར་བ_ཐ་དད་པ
མཐུན | གཟུགས་མི་འགྱུར་བ_ཐ་མི་དད་པ
མཐོང | བྱ་ཚིག_###+གཟུགས་མི་འགྱུར་བ_ཐ་མི་དད་པ
མཐོལ | གཟུགས་མི་འགྱུར་བ_ཐ་མི་དད་པ
མདུད | གཟུགས་མི་འགྱུར་བ_ཐ་དད་པ
མནག | མནག_མ་འོངས་པ།_ཐ་དད་པ+མནག_ད་ལྟ་བ།_ཐ་དད་པ
མནགས | མནག_འདས་པ།_ཐ་དད་པ
མནན | གནོན_མ་འོངས་པ།_ཐ་དད་པ+གནོན_འདས་པ།_ཐ་དད་པ+མནན_འདས་པ།_ཐ་དད་པ+མནན_མ་འོངས་པ།_ཐ་དད་པ
མནབ | ནབ_མ་འོངས་པ།_ཐ་དད་པ
མནབས | ནབ_འདས་པ།_ཐ་དད་པ
མནམ | ནོམ_མ་འོངས་པ།_###+ནོམ_མ་འོངས་པ།_ཐ་མི་དད་པ+ནོམ_མ་འོངས་པ།_ཐ་དད་པ
མནམས | ནོམ_འདས་པ།_ཐ་མི་དད་པ+ནོམ_འདས་པ།_###+ནོམ_འདས་པ།_ཐ་དད་པ
མནར | བྱ་ཚིག_###+གཟུགས་མི་འགྱུར་བ_ཐ་དད་པ
མནལ | མནལ_མ་འོངས་པ།_ཐ་མི་དད་པ+མནལ_འདས་པ།_ཐ་མི་དད་པ+མནལ_ད་ལྟ་བ།_ཐ་མི་དད་པ
མནོ | མནོ_ད་ལྟ་བ།_###+མནོས_མ་འོངས་པ།_###+མནོ_ད་ལྟ་བ།_ཐ་དད་པ+མནོ_མ་འོངས།_ཐ་དད་པ+མནོས_ད་ལྟ་བ།_###+མནོ_མ་འོངས་པ།_###
མནོགས | མནག_སྐུལ་ཚིག_ཐ་དད་པ
མནོང | ནོངས_འབྲི་ཚུལ+བྱ་ཚིག_ཐ་མི་དད་པ
མནོད | ནོད_མ་འོངས་པ།_ཐ་དད་པ
མནོལ | གཟུགས་མི་འགྱུར་བ_ཐ་མི་དད་པ+མནལ_སྐུལ་ཚིག_ཐ་མི་དད་པ
མནོས | མནོ_འདས་པ།_ཐ་དད་པ+མནོ_སྐུལ་ཚིག_###+མནོས_སྐུལ་ཚིག_###+ནོད_འདས་པ།_ཐ་དད་པ+མནོས_འདས་པ།_###+མནོ_སྐུལ་ཚིག_ཐ་དད་པ+མནོ_འདས་པ།_###
མཚན | མཚན_མ་འོངས་པ།_ཐ་དད་པ+མཚན_ད་ལྟ་བ།_ཐ་དད་པ+མཚན_འདས་པ།_ཐ་དད་པ
མཚོན | མཚན_སྐུལ་ཚིག_ཐ་དད་པ
མཛད | མཛོད_འདས་པ།_ཐ་དད་པ+མཛོད_ད་ལྟ་བ།_ཐ་དད་པ+མཛད_མ་འོངས་པ།_ཐ་དད་པ+མཛད_འདས་པ།_ཐ་དད་པ+མཛོད_མ་འོངས་པ།_ཐ་དད་པ+མཛད_ད་ལྟ་བ།_ཐ་དད་པ
མཛོད | མཛོད_སྐུལ་ཚིག_ཐ་དད་པ+མཛད_སྐུལ་ཚིག_ཐ་དད་པ
མིད | གཟུགས་མི་འགྱུར་བ_ཐ་དད་པ
མུག | གཟུགས་མི་འགྱུར་བ_ཐ་མི་དད་པ+བྱ་ཚིག_###
མུར | གཟུགས་མི་འགྱུར་བ_ཐ་དད་པ
མོལ | བྱ་ཚིག_###+གཟུགས་མི་འགྱུར་བ_ཐ་དད་པ
མོས | བྱ་ཚིག_###+གཟུགས་མི་འགྱུར་བ_ཐ་མི་དད་པ
མྱགས | བྱ་ཚིག_###+གཟུགས་མི་འགྱུར་བ_ཐ་དད་པ
མྱང | མྱོང_མ་འོངས་པ།_ཐ་མི་དད་པ+མྱོང_མ་འོངས་པ།_ཐ་དད་པ
མྱངས | མྱོང_འདས་པ།_ཐ་དད་པ+མྱོང_འདས་པ།_ཐ་མི་དད་པ
མྱིད | གཟུགས་མི་འགྱུར་བ_ཐ་དད་པ
མྱུག | མྱུག_མ་འོངས་པ།_ཐ་དད་པ+གཟུགས་མི་འགྱུར་བ_ཐ་མི་དད་པ+མྱུག_ད་ལྟ་བ།_ཐ་དད་པ+མྱུག_མ་འོངས་པ།_###+མྱུག_ད་ལྟ་བ།_###
མྱུགས | མྱུག_འདས་པ།_ཐ་དད་པ+མྱུག_སྐུལ་ཚིག_###+མྱུག_འདས་པ།_###+མྱུག_སྐུལ་ཚིག_ཐ་དད་པ
མྱུལ | བྱ་ཚིག_###+གཟུགས་མི་འགྱུར་བ_ཐ་དད་པ
མྱོང | མྱོང_ད་ལྟ་བ།_ཐ་དད་པ+མྱོང_ད་ལྟ་བ།_ཐ་མི་དད་པ
མྱོངས | མྱོང_སྐུལ་ཚིག_ཐ་དད་པ
མྱོས | གཟུགས་མི་འགྱུར་བ_ཐ་མི་དད་པ
ཚགས | གཟུགས་མི་འགྱུར་བ_ཐ་དད་པ
ཚང | གཟུགས་མི་འགྱུར་བ_ཐ་མི་དད་པ+འཚང_འདས་པ།_###
ཚད | ཚད_ད་ལྟ་བ།_ཐ་དད་པ+ཚད_འདས་པ།_###+ཚད_མ་འོངས་པ།_ཐ་དད་པ+ཚད_འདས་པ།_ཐ་དད་པ+ཚད_མ་འོངས་པ།_###+ཚད_ད་ལྟ་བ།_###
ཚར | གཟུགས་མི་འགྱུར་བ_ཐ་མི་དད་པ
ཚིག | འཚིག_འདས་པ།_ཐ་མི་དད་པ+འཚིག_འདས་པ།_###
ཚིམ | ཚིམ_མ་འོངས་པ།_ཐ་མི་དད་པ+ཚིམ_ད་ལྟ་བ།_ཐ་མི་དད་པ
ཚིམས | ཚིམ_འདས་པ།_ཐ་མི་དད་པ
ཚིར | བཙིར_སྐུལ་ཚིག_ཐ་དད་པ+འཚིར_སྐུལ་ཚིག_ཐ་དད་པ
ཚུགས | གཟུགས་མི་འགྱུར་བ_ཐ་མི་དད་པ+འཛུགས_སྐུལ་ཚིག_###+འཛུགས_སྐུལ་ཚིག_ཐ་དད་པ
ཚུད | གཟུགས་མི་འགྱུར་བ_ཐ་མི་དད་པ+འཚུད_འདས་པ།_ཐ་མི་དད་པ
ཚུམ | གཟུམ_སྐུལ་ཚིག_ཐ་དད་པ
ཚུམས | འཚུམ_སྐུལ་ཚིག_ཐ་དད་པ
ཚེམ | འཚེམ_འབྲི་ཚུལ+བྱ་ཚིག_ཐ་དད་པ
ཚེམས | འཚེམ_སྐུལ་ཚིག_ཐ་དད་པ
ཚེས | གཟུགས་མི་འགྱུར་བ_ཐ་མི་དད་པ
ཚོག | འཚག_སྐུལ་ཚིག_ཐ་དད་པ+འཚོག_སྐུལ་ཚིག_ཐ་དད་པ
ཚོགས | གཟུགས་མི་འགྱུར་བ_ཐ་མི་དད་པ
ཚོངས | འཚང_སྐུལ་ཚིག_ཐ་དད་པ+འཚོང_སྐུལ་ཚིག_ཐ་དད་པ
ཚོད | ཚད_སྐུལ་ཚིག_ཐ་དད་པ+ཚད_སྐུལ་ཚིག_###
ཚོབས | འཚོབ_འདས་པ།_ཐ་མི་དད་པ+འཚབ_སྐུལ་ཚིག_ཐ་དད་པ
ཚོམ | གཟུགས་མི་འགྱུར་བ_ཐ་མི་དད་པ
ཚོར | གཟུགས་མི་འགྱུར་བ_ཐ་དད་པ
ཚོལ | བཙལ_སྐུལ་ཚིག།_འབྲི་ཚུལ
ཚོས | གཟུགས་མི་འགྱུར་བ_ཐ་མི་དད་པ+འཚོད_སྐུལ་ཚིག_###+འཚོད_སྐུལ་ཚིག_ཐ་དད་པ
ཞ | གཟུགས་མི་འགྱུར་བ_ཐ་མི་དད་པ+བྱ་ཚིག_###+ཕྱ_འབྲི་ཚུལ
ཞར | གཟུགས་མི་འགྱུར་བ_ཐ་མི་དད་པ
ཞལ | གཟུགས་མི་འགྱུར་བ_ཐ་དད་པ
ཞི | གཟུགས་མི་འགྱུར་བ_ཐ་མི་དད་པ
ཞིག | འཇིག_འདས་པ།_ཐ་མི་དད་པ
ཞིབ | བྱ་ཚིག_###+གཟུགས་མི་འགྱུར་བ_ཐ་མི་དད་པ
ཞིལ | བྱིལ_འབྲི་ཚུལ+གཟུགས་མི་འགྱུར་བ_ཐ་མི་དད་པ+གཟུགས་མི་འགྱུར་བ_ཐ་དད་པ
ཞུ | ཞུ_ད་ལྟ་བ།_ཐ་དད་པ+ཞུས_ད་ལྟ་བ།_ཐ་དད་པ+གཟུགས་མི་འགྱུར་བ_ཐ་མི་དད་པ+ཞུས_མ་འོངས་པ།_ཐ་དད་པ+འཇུ_འདས་པ།_ཐ་མི་དད་པ+ཞུ_མ་འོངས་པ།_ཐ་དད་པ+བཞུ_སྐུལཚིག_འབྲི་ཚུལ
ཞུགས | འཇུག_འདས་པ།_ཐ་མི་དད་པ+གཟུགས་མི་འགྱུར་བ_ཐ་མི་དད་པ
ཞུམ | གཟུགས་མི་འགྱུར་བ_ཐ་མི་དད་པ
ཞུས | ཞུ_འདས་པ།_ཐ་དད་པ+ཞུས_འདས་པ།_ཐ་དད་པ+ཞུ_སྐུལ་ཚིག_ཐ་དད་པ+བཞུ_སྐུལ་ཚིག_ཐ་དད་པ+ཞུས_སྐུལ་ཚིག_ཐ་དད་པ
ཞེད | གཟུགས་མི་འགྱུར་བ_ཐ་མི་དད་པ
ཞེན | གཟུགས་མི་འགྱུར་བ_ཐ་མི་དད་པ
ཞོག | འཇོག_སྐུལ་ཚིག_ཐ་དད་པ+གཞོག_སྐུལ་ཚིག_ཐ་དད་པ+འཇོག_སྐུལ་ཚིག_###
ཞོགས | གཟུགས་མི་འགྱུར་བ_ཐ་མི་དད་པ
ཞོན | བཞོན_སྐུལ་ཚིག_ཐ་དད་པ+ཞོན_ད་ལྟ་བ།_ཐ་དད་པ+བཞོན_ད་ལྟ་བ།_ཐ་དད་པ+ཞོན_སྐུལ་ཚིག_ཐ་དད་པ
ཞོམ | གཟུགས་མི་འགྱུར་བ_ཐ་མི་དད་པ
ཞོས | འཇོ_སྐུལ་ཚིག_ཐ་དད་པ
ཟ | ཟ_མ་འོངས་པ།_ཐ་མི་དད་པ+ཟ_ད་ལྟ་བ།_###+ཟ_ད་ལྟ་བ།_ཐ་མི་དད་པ+ཟ_ད་ལྟ་བ།_ཐ་དད་པ+ཟ_མ་འོངས་པ།_###
ཟག | ཟག_ད་ལྟ་བ།_ཐ་མི་དད་པ+ཟག_ད་ལྟ་བ།_###+ཟག_མ་འོངས་པ།_###+ཟག_མ་འོངས་པ།_ཐ་མི་དད་པ
ཟགས | ཟག_འདས་པ།_###+འཛག_འདས་པ།_ཐ་མི་དད་པ+ཟག_འདས་པ།_ཐ་མི་དད་པ
ཟད | འཛད_འདས་པ།_ཐ་མི་དད་པ
ཟིན | བྱ་ཚིག_###+གཟུགས་མི་འགྱུར་བ_ཐ་མི་དད་པ
ཟུག | བྱ་ཚིག_###+གཟུགས་མི་འགྱུར་བ_###
ཟུང | འཛིན_སྐུལ་ཚིག_ཐ་དད་པ+འཛིན_སྐུལ་ཚིག_###
ཟུངས | འཛིན_སྐུལཚིག_འབྲི་ཚུལ
ཟུད | བཙུད_སྐུལཚིག_འབྲི་ཚུལ
ཟུམ | གཟུགས་མི་འགྱུར་བ_ཐ་མི་དད་པ+བྱ་ཚིག_ཐ་དད་པ
ཟུར | འཛུར_སྐུལ་ཚིག_ཐ་མི་དད་པ
ཟེགས | གཟུགས་མི་འགྱུར་བ_ཐ་མི་དད་པ+བྱ་ཚིག_###
ཟེད | འཛེད_སྐུལ་ཚིག_ཐ་དད་པ+ཟེལ_འབྲི་ཚུལ
ཟེམ | འཛེམ_འབྲི་ཚུལ+བྱ་ཚིག_ཐ་དད་པ
ཟེར | གཟུགས་མི་འགྱུར་བ_ཐ་དད་པ
ཟོ | ཟ_སྐུལ་ཚིག_ཐ་དད་པ
ཟོས | བྱ་ཚིག_ཐ་མི་དད་པ+ཟ_འདས་པ།_ཐ་མི་དད་པ+ཟ_འདསཔ_འབྲི་ཚུལ+ཟ_འདས་པ།_###+འཛའ_འདས་པ།_ཐ་མི་དད་པ
ཟླུག | ཟླུག_ད་ལྟ་བ།_ཐ་དད་པ+བྱ་ཚིག_###
ཟླུགས | ཟླུག_སྐུལ་ཚིག_ཐ་དད་པ
ཟླུམ | ཟླུམ_ད་ལྟ་བ།_ཐ་དད་པ
ཟླུམས | ཟླུམ_སྐུལ་ཚིག_འབྲི་ཚུལ
ཟློ | ཟློ_ད་ལྟ་བ།_ཐ་དད་པ+ཟློ_ད་ལྟ་བ།_###+ཟློས_ད་ལྟ་བ།_ཐ་དད་པ
ཟློག | ཟློག_ད་ལྟ་བ།_###+ཟློག_ད་ལྟ་བ།_ཐ་དད་པ
ཟློགས | ཟློག_སྐུལ་ཚིག_ཐ་དད་པ+ཟློག_སྐུལ་ཚིག_###
ཟློས | ཟློས_འདས་པ།_ཐ་དད་པ+ཟློ_སྐུལ་ཚིག_###+ཟློ_འདས་པ།_###+ཟློ_སྐུལ་ཚིག_ཐ་དད་པ+ཟློས_སྐུལ་ཚིག_ཐ་དད་པ
འཁང | འཁང_མ་འོངས་པ།_ཐ་མི་དད་པ+འཁང_ད་ལྟ་བ།_ཐ་མི་དད་པ
འཁངས | འཁང_འདས་པ།_ཐ་མི་དད་པ
འཁལ | འཁེལ_འབྲི་ཚུལ+བྱ་ཚིག_ཐ་དད་པ
འཁུ | འཁུ_མ་འོངས་པ།_ཐ་མི་དད་པ+འཁུ_ད་ལྟ་བ།_ཐ་མི་དད་པ
འཁུན | གཟུགས་མི་འགྱུར་བ_ཐ་མི་དད་པ
འཁུམ | འཁུམ_ད་ལྟ་བ།_ཐ་དད་པ+འཁུམ_མ་འོངས་པ།_ཐ་མི་དད་པ+འཁུམ_མ་འོངས་པ།_ཐ་དད་པ+འཁུམ_ད་ལྟ་བ།_ཐ་མི་དད་པ
འཁུམས | འཁུམ_འདས་པ།_ཐ་མི་དད་པ+འཁུམ_འདས་པ།_ཐ་དད་པ
འཁུར | འཁུར_ད་ལྟ་བ།_ཐ་དད་པ+ཁུར_ད་ལྟ་བ།_ཐ་དད་པ+འཁུར_མ་འོངས་པ།_ཐ་དད་པ+ཁུར_མ་འོངས་པ།_ཐ་དད་པ
འཁུས | འཁུ_འདས་པ།_ཐ་མི་དད་པ+འཁུ_སྐུལ་ཚིག_ཐ་མི་དད་པ
འཁེགས | ཁེགས_འབྲི་ཚུལ+བྱ་ཚིག_ཐ་མི་དད་པ
འཁེང | འཁེང_མ་འོངས་པ།_ཐ་མི་དད་པ+འཁེང_ད་ལྟ་བ།_ཐ་མི་དད་པ
འཁེངས | འཁེང_འདས་པ།_ཐ་མི་དད་པ
འཁེབ | ཁེབ_འབྲི་ཚུལ+བྱ་ཚིག_###
འཁེལ | འཁེལ_ད་ལྟ་བ།_###+འཁེལ_ད་ལྟ་བ།_ཐ་དད་པ+འཁེལ_མ་འོངས་པ།_###+འགེལ_ད་ལྟ་བ།_###
འཁོད | བཀོད_སྐུལཚིག_འབྲི་ཚུལ+གཟུགས་མི་འགྱུར་བ_ཐ་མི་དད་པ
འཁོན | འཁོན_ད་ལྟ་བ།_ཐ་དད་པ+འཁོན_སྐུལ་ཚིག_ཐ་དད་པ+འཁོན_ད་ལྟ་བ།_ཐ་མི་དད་པ+བཀོན_སྐུལ་ཚིག_ཐ་མི་དད་པ+བཀོན_ད་ལྟ་བ།_ཐ་མི་དད་པ
འཁོབ | འཁོབ_མ་འོངས་པ།_ཐ་མི་དད་པ+འཁོབ_ད་ལྟ་བ།_ཐ་མི་དད་པ
འཁོབས | འཁོབ_འདས་པ།_ཐ་མི་དད་པ
འཁོར | བྱ་ཚིག_###+གཟུགས་མི་འགྱུར་བ_ཐ་མི་དད་པ
འཁོལ | ཁོལ_མ་འོངས་པ།_ཐ་མི་དད་པ+འཁོལ_ད་ལྟ་བ།_ཐ་དད་པ+འཁོལ_ད་ལྟ་བ།_###
འཁྱག | འཁྱག_ད་ལྟ་བ།_ཐ་མི་དད་པ+འཁྱག_མ་འོངས་པ།_ཐ་མི་དད་པ
འཁྱགས | འཁྱག_འདས་པ།_ཐ་མི་དད་པ
འཁྱམ | འཁྱམ_མ་འོངས་པ།_ཐ་མི་དད་པ+འཁྱམ_ད་ལྟ་བ།_ཐ་མི་དད་པ
འཁྱམས | འཁྱམ_འདས་པ།_ཐ་མི་དད་པ
འཁྱར | གཟུགས་མི་འགྱུར་བ_ཐ་མི་དད་པ+བྱ་ཚིག_###
འཁྱལ | བྱ་ཚིག_###+འཁྱལ_ད་ལྟ་བ།_ཐ་མི་དད་པ+བཀྱལ_ད་ལྟ་བ།_ཐ་མི་དད་པ
འཁྱིག | འཁྱིག_ད་ལྟ་བ།_###+འཁྱིག_མ་འོངས་པ།_###+འཁྱིག_ད་ལྟ་བ།_ཐ་དད་པ
འཁྱིགས | འཁྱིག_འདས་པ།_###
འཁྱིམས | གཟུགས་མི་འགྱུར་བ_ཐ་མི་དད་པ+བྱ་ཚིག_###
འཁྱིར | གཟུགས་མི་འགྱུར་བ_ཐ་དད་པ
འཁྱིལ | གཟུགས་མི་འགྱུར་བ_ཐ་མི་དད་པ+བྱ་ཚིག_###
འཁྱུག | འཁྱུག_ད་ལྟ་བ།_ཐ་མི་དད་པ+འཁྱུག_མ་འོངས་པ།_ཐ་མི་དད་པ
འཁྱུགས | འཁྱུག_འདས་པ།_ཐ་མི་དད་པ
འཁྱུད | གཟུགས་མི་འགྱུར་བ_ཐ་མི་དད་པ
འཁྱུས | གཟུགས་མི་འགྱུར་བ_ཐ་མི་དད་པ
འཁྱེ | གྱེས_ད་ལྟ་བ།_ཐ་མི་དད་པ
འཁྱེར | ཁྱེར_ད་ལྟ་བ།_ཐ་དད་པ+འཁྱེར_མ་འོངས་པ།_ཐ་དད་པ+ཁྱེར_མ་འོངས་པ།_ཐ་དད་པ+འཁྱེར_ད་ལྟ་བ།_ཐ་དད་པ
འཁྱོག | འཁྱོག_མ་འོངས་པ།_ཐ་མི་དད་པ+འཁྱོག_ད་ལྟ་བ།_ཐ་མི་དད་པ
འཁྱོགས | འཁྱོག_འདས་པ།_ཐ་མི་དད་པ
འཁྱོང | འཁྱོང_མ་འོངས་པ།_###+འཁྱོང_མ་འོངས་པ།_ཐ་དད་པ+འཁྱོང_ད་ལྟ་བ།_ཐ་མི་དད་པ+འཁྱོང_ད་ལྟ་བ།_###+འཁྱོངས_མ་འོངས་པ།_ཐ་དད་པ+འཁྱོང_ད་ལྟ་བ།_ཐ་དད་པ+འཁྱོངས_ད་ལྟ་བ།_ཐ་དད་པ+འཁྱོང_མ་འོངས་པ།_ཐ་མི་དད་པ
འཁྱོངས | འཁྱོང_སྐུལ་ཚིག_###+འཁྱོང_སྐུལ་ཚིག_ཐ་དད་པ+འཁྱོང_འདས་པ།_ཐ་དད་པ+འཁྱོངས_སྐུལ་ཚིག_ཐ་དད་པ+འཁྱོང_འདས་པ།_ཐ་མི་དད་པ+འཁྱོང_འདས་པ།_###+འཁྱོངས_འདས་པ།_ཐ་དད་པ
འཁྱོམ | འཁྱོམ_མ་འོངས་པ།_ཐ་མི་དད་པ+འཁྱོམ_ད་ལྟ་བ།_ཐ་མི་དད་པ
འཁྱོམས | འཁྱམ_སྐུལ་ཚིག_ཐ་མི་དད་པ+འཁྱོམ_འདས་པ།_ཐ་མི་དད་པ
འཁྱོར | གཟུགས་མི་འགྱུར་བ_ཐ་མི་དད་པ
འཁྱོལ | གཟུགས་མི་འགྱུར་བ_ཐ་མི་དད་པ
འཁྲ | འཁྲས_ད་ལྟ་བ།_ཐ་མི་དད་པ+འཁྲ_ད་ལྟ་བ།_ཐ་མི་དད་པ+འཁྲས_མ་འོངས་པ།_ཐ་མི་དད་པ+འཁྲ_མ་འོངས་པ།_ཐ་མི་དད་པ
འཁྲད | གཟུགས་མི་འགྱུར་བ_ཐ་དད་པ
འཁྲབ | འཁྲབ_ད་ལྟ་བ།_ཐ་དད་པ+འཁྲབ_མ་འོངས་པ།_###+འཁྲབ_ད་ལྟ་བ།_###
འཁྲབས | འཁྲབ_འདས་པ།_###
འཁྲས | འཁྲས_འདས་པ།_ཐ་མི་དད་པ+འཁྲ_འདས་པ།_ཐ་མི་དད་པ+འཁྲས_སྐུལ་ཚིག_ཐ་མི་དད་པ+འཁྲ_སྐུལ་ཚིག_ཐ་མི་དད་པ
འཁྲིག | གཟུགས་མི་འགྱུར་བ_ཐ་མི་དད་པ
འཁྲིགས | གཟུགས་མི་འགྱུར་བ_ཐ་མི་དད་པ
འཁྲིད | ཁྲིད_ད་ལྟ་བ།_ཐ་དད་པ+འཁྲིད_ད་ལྟ་བ།_###+ཁྲིད_མ་འོངས་པ།_ཐ་དད་པ+འཁྲིད_མ་འོངས་པ།_ཐ་དད་པ+འཁྲིད_ད་ལྟ་བ།_ཐ་དད་པ
འཁྲིམས | གཟུགས་མི་འགྱུར་བ_ཐ་མི་དད་པ
འཁྲིལ | གཟུགས་མི་འགྱུར་བ_ཐ་དད་པ
འཁྲིས | འཁྲི_འདས་པ།_འབྲི་ཚུལ
འཁྲུ | འཁྲུ_མ་འོངས་པ།_ཐ་མི་དད་པ+འཁྲུ_ད་ལྟ་བ།_ཐ་མི་དད་པ
འཁྲུག | འཁྲུག_མ་འོངས་པ།_ཐ་མི་དད་པ+འཁྲུག_མ་འོངས་པ།_ཐ་དད་པ+འཁྲུག_ད་ལྟ་བ།_###+འཁྲུག_ད་ལྟ་བ།_ཐ་མི་དད་པ+འཁྲུགས_ད་ལྟ་བ།_ཐ་དད་པ+འཁྲུག_ད་ལྟ་བ།_ཐ་དད་པ+འཁྲུགས_མ་འོངས་པ།_ཐ་དད་པ+འཁྲུག_མ་འོངས་པ།_###
འཁྲུགས | འཁྲུག_འདས་པ།_###+འཁྲུགས_སྐུལ་ཚིག_ཐ་དད་པ+འཁྲུགས_འདས་པ།_ཐ་དད་པ+འཁྲུག_འདས་པ།_ཐ་དད་པ+འཁྲུག_འདས་པ།_ཐ་མི་དད་པ+འཁྲུག_སྐུལ་ཚིག_ཐ་དད་པ
འཁྲུང | འཁྲུང_མ་འོངས་པ།_ཐ་མི་དད་པ+འཁྲུང_ད་ལྟ་བ།_ཐ་མི་དད་པ
འཁྲུངས | འཁྲུང_འདས་པ།_ཐ་མི་དད་པ
འཁྲུད | འཁྲུད_ད་ལྟ་བ།_ཐ་དད་པ
འཁྲུལ | གཟུགས་མི་འགྱུར་བ_ཐ་དད་པ
འཁྲུས | འཁྲུ_འདས་པ།_ཐ་མི་དད་པ
འཁྲེང | གཟུགས་མི་འགྱུར་བ_ཐ་མི་དད་པ
འཁྲེན | གཟུགས་མི་འགྱུར་བ_ཐ་མི་དད་པ
འཁྲེབ | འཁྲེབ_ད་ལྟ་བ།_ཐ་མི་དད་པ+གཟུགས་མི་འགྱུར་བ_ཐ་དད་པ+འཁྲེབ_མ་འོངས་པ།_ཐ་མི་དད་པ
འཁྲེབས | འཁྲེབ_འདས་པ།_ཐ་མི་དད་པ
འཁྲོ | ཁྲོ_དལྟབ_འབྲི་ཚུལ+བྱ་ཚིག_ཐ་མི་དད་པ
འཁྲོག | འཁྲོག_མ་འོངས་པ།_ཐ་མི་དད་པ+འཁྲོགས_མ་འོངས་པ།_ཐ་མི་དད་པ+འཁྲོག_ད་ལྟ་བ།_ཐ་དད་པ+འཁྲོག_ད་ལྟ་བ།_ཐ་མི་དད་པ+འཁྲོགས_ད་ལྟ་བ།_ཐ་མི་དད་པ+འཁྲོག_མ་འོངས་པ།_ཐ་དད་པ
འཁྲོགས | འཁྲོགས_འདས་པ།_ཐ་མི་དད་པ+འཁྲོག_འདས་པ།_ཐ་མི་དད་པ+འཁྲོག_འདས་པ།_ཐ་དད་པ
འཁྲོབས | འཁྲབ_སྐུལ་ཚིག_###
འཁྲོལ | འཁྲོལ_ད་ལྟ་བ།_ཐ་དད་པ+འཁྲོལ_ད་ལྟ་བ།_###
འཁྲོས | ཁྲོ_འདསཔ_འབྲི་ཚུལ+བྱ་ཚིག_ཐ་མི་དད་པ
འགག | འགག_ད་ལྟ་བ།_ཐ་མི་དད་པ+འགག_མ་འོངས་པ།_###+འགག_ད་ལྟ་བ།_###+འགག_མ་འོངས་པ།_ཐ་མི་དད་པ
འགགས | འགག_འདས་པ།_ཐ་མི་དད་པ+འགག_འདས་པ།_###
འགད | འགད_ད་ལྟ་བ།_###+འགད_ད་ལྟ་བ།_ཐ་དད་པ
འགམ | འགེམ_མ་འོངས་པ།_###
འགམས | འགེམ_འདས་པ།_###
འགལ | གཟུགས་མི་འགྱུར་བ_ཐ་མི་དད་པ
འགས | འགས_ད་ལྟ་བ།_ཐ་དད་པ
འགུག | འགུགས_འབྲི་ཚུལ+བྱ་ཚིག_ཐ་དད་པ
འགུགས | འགུགས_ད་ལྟ་བ།_ཐ་དད་པ+འགུགས_ད་ལྟ་བ།_###
འགུམ | འགུམ_ད་ལྟ་བ།_ཐ་དད་པ
འགུལ | གཟུགས་མི་འགྱུར་བ_ཐ་མི་དད་པ
འགེགས | བཀག_དལྟབ_འབྲི་ཚུལ+བྱ་ཚིག_ཐ་དད་པ
འགེངས | འགེངས_ད་ལྟ་བ།_ཐ་དད་པ
འགེབ | འགེབ_ད་ལྟ་བ།_ཐ་དད་པ+འགེབ_ད་ལྟ་བ།_###
འགེམ | འགེམ_མ་འོངས་པ།_ཐ་དད་པ+འགེམས_ད་ལྟ་བ།_ཐ་དད་པ+འགེམ_ད་ལྟ་བ།_###+འགེམས_མ་འོངས་པ།_ཐ་དད་པ+འགེམ_ད་ལྟ་བ།_ཐ་དད་པ
འགེམས | འགེམས_འདས་པ།_ཐ་དད་པ+འགེམ_འདས་པ།_ཐ་དད་པ+འགེམ_སྐུལ་ཚིག_ཐ་དད་པ+འགེམས_སྐུལ་ཚིག_ཐ་དད་པ
འགེར | འགེར_ད་ལྟ་བ།_ཐ་དད་པ+འགེར_ད་ལྟ་བ།_###
འགེལ | བཀལ_འདས་པ།_འབྲི་ཚུལ
འགོ | འགོ_མ་འོངས་པ།_ཐ་མི་དད་པ+འགོ_ད་ལྟ་བ།_ཐ་མི་དད་པ
འགོག | འགོག_ད་ལྟ་བ།_ཐ་དད་པ+འགོག_ད་ལྟ་བ།_###
འགོང | འགོང_མ་འོངས་པ།_###+འགོང_ད་ལྟ་བ།_ཐ་དད་པ+འགོངས_ད་ལྟ་བ།_ཐ་མི་དད་པ+འགོངས_ད་ལྟ་བ།_ཐ་དད་པ+འགོངས_མ་འོངས་པ།_ཐ་དད་པ+འགོང_ད་ལྟ་བ།_###+འགོངས_མ་འོངས་པ།_ཐ་མི་དད་པ+འགོང_མ་འོངས་པ།_ཐ་དད་པ+འགོང_མ་འོངས་པ།_ཐ་མི་དད་པ+འགོང_ད་ལྟ་བ།_ཐ་མི་དད་པ
འགོངས | འགོངས_འདས་པ།_ཐ་དད་པ+འགོང_འདས་པ།_ཐ་དད་པ+འགོང_འདས་པ།_###+འགོངས_སྐུལ་ཚིག_ཐ་དད་པ+འགོང_འདས་པ།_ཐ་མི་དད་པ+འགོང_སྐུལ་ཚིག_ཐ་དད་པ+འགོངས_འདས་པ།_ཐ་མི་དད་པ
འགོད | འགོད_ད་ལྟ་བ།_ཐ་དད་པ
འགོམ | འགོམ_ད་ལྟ་བ།_ཐ་དད་པ
འགོམས | འགེམ_སྐུལ་ཚིག_###+འགོམ_སྐུལ་ཚིག_ཐ་དད་པ
འགོར | བགོར_ད་ལྟ་བ།_ཐ་དད་པ+གཟུགས་མི་འགྱུར་བ_ཐ་མི་དད་པ+འགོར_ད་ལྟ་བ།_ཐ་དད་པ
འགོས | འགོ_འདས་པ།_ཐ་མི་དད་པ
འགྱང | འགྱང_མ་འོངས་པ།_ཐ་མི་དད་པ+འགྱང_ད་ལྟ་བ།_ཐ་མི་དད་པ
འགྱངས | འགྱང_འདས་པ།_ཐ་མི་དད་པ
འགྱམ | གཟུགས་མི་འགྱུར་བ_ཐ་མི་དད་པ
འགྱིང | འགྱིངས_ད་ལྟ་བ།_ཐ་མི་དད་པ+འགྱིང_ད་ལྟ་བ།_ཐ་མི་དད་པ+འགྱིང_མ་འོངས་པ།_ཐ་མི་དད་པ+འགྱིངས_མ་འོངས་པ།_ཐ་མི་དད་པ
འགྱིངས | འགྱིང_འདས་པ།_ཐ་མི་དད་པ+འགྱིངས_སྐུལ་ཚིག_ཐ་མི་དད་པ+འགྱིངས_འདས་པ།_ཐ་མི་དད་པ+འགྱིང_སྐུལ་ཚིག_ཐ་མི་དད་པ
འགྱུ | འགྱུ_ད་ལྟ་བ།_ཐ་མི་དད་པ+འགྱུ_ད་ལྟ་བ།_###+འགྱུ_མ་འོངས་པ།_ཐ་མི་དད་པ+འགྱུ_མ་འོངས་པ།_###
འགྱུར | གཟུགས་མི་འགྱུར་བ_###+འགྱུར_ད་ལྟ་བ།_ཐ་མི་དད་པ+འགྱུར_མ་འོངས་པ།_ཐ་མི་དད་པ
འགྱུས | འགྱུ_འདས་པ།_###+འགྱུ_སྐུལ་ཚིག_###+འགྱུ_འདས་པ།_ཐ་མི་དད་པ
འགྱེ | འགྱེ_ད་ལྟ་བ།_ཐ་མི་དད་པ+འགྱེ_མ་འོངས་པ།_ཐ་མི་དད་པ+གྱེས_མ་འོངས་པ།_ཐ་མི་དད་པ
འགྱེད | འགྱེད_ད་ལྟ་བ།_###+འགྱེད_མ་འོངས་པ།_###+འགྱེད_ད་ལྟ་བ།_ཐ་དད་པ
འགྱེལ | གཟུགས་མི་འགྱུར་བ_ཐ་མི་དད་པ
འགྱོག | འགྱོག_ད་ལྟ་བ།_ཐ་དད་པ
འགྱོད | གཟུགས་མི་འགྱུར་བ_ཐ་མི་དད་པ
འགྲང | འགྲང_ད་ལྟ་བ།_ཐ་མི་དད་པ+འགྲང_མ་འོངས་པ།_ཐ་མི་དད་པ
འགྲངས | འགྲང_འདས་པ།_ཐ་མི་དད་པ
འགྲན | གཟུགས་མི་འགྱུར་བ_ཐ་དད་པ
འགྲས | གཟུགས་མི་འགྱུར་བ_ཐ་མི་དད་པ
འགྲིག | འགྲིག_མ་འོངས་པ།_ཐ་མི་དད་པ+འགྲིག_ད་ལྟ་བ།_ཐ་མི་དད་པ+འགྲིག_མ་འོངས་པ།_###+འགྲིག_ད་ལྟ་བ།_###
འགྲིགས | འགྲིག_འདས་པ།_###+འགྲིག_འདས་པ།_ཐ་མི་དད་པ
འགྲིབ | གཟུགས་མི་འགྱུར་བ_ཐ་དད་པ
འགྲིམ | འགྲིམ_ད་ལྟ་བ།_###+འགྲིམས_མ་འོངས་པ།_ཐ་མི་དད་པ+འགྲིམ_མ་འོངས་པ།_ཐ་མི་དད་པ+འགྲིམས_ད་ལྟ་བ།_ཐ་མི་དད་པ+འགྲིམ_ད་ལྟ་བ།_ཐ་མི་དད་པ+འགྲིམ_མ་འོངས་པ།_###
འགྲིམས | འགྲིམས_སྐུལ་ཚིག_ཐ་མི་དད་པ+འགྲིམ_འདས་པ།_###+འགྲིམ_འདས་པ།_ཐ་མི་དད་པ+འགྲིམ_སྐུལ་ཚིག_ཐ་མི་དད་པ+འགྲིམ_སྐུལ་ཚིག_###+འགྲིམས_འདས་པ།_ཐ་མི་དད་པ
འགྲིལ | འགྲིལ_མ་འོངས་པ།_ཐ་མི་དད་པ+འགྲིལ_ད་ལྟ་བ།_ཐ་མི་དད་པ
འགྲུབ | འགྲུབ_མ་འོངས་པ།_ཐ་མི་དད་པ+འགྲུབ_ད་ལྟ་བ།_ཐ་མི་དད་པ
འགྲེ | འགྲེ_ད་ལྟ་བ།_ཐ་མི་དད་པ+འགྲེ_མ་འོངས་པ།_###+འགྲེ_མ་འོངས་པ།_ཐ་མི་དད་པ+འགྲེ_ད་ལྟ་བ།_###
འགྲེང | འགྲེང_ད་ལྟ་བ།_ཐ་མི་དད་པ+འགྲེངས_ད་ལྟ་བ།_ཐ་མི་དད་པ+འགྲེངས_མ་འོངས་པ།_ཐ་མི་དད་པ+འགྲེང_མ་འོངས་པ།_ཐ་མི་དད་པ
འགྲེངས | འགྲེང_འདས་པ།_ཐ་མི་དད་པ+འགྲེངས_འདས་པ།_ཐ་མི་དད་པ+འགྲེང_སྐུལ་ཚིག_ཐ་མི་དད་པ+འགྲེངས_སྐུལ་ཚིག_ཐ་མི་དད་པ
འགྲེད | གཟུགས་མི་འགྱུར་བ_ཐ་མི་དད་པ+འདྲེད_འབྲི་ཚུལ
འགྲེམ | ཁྲོམ_ད་ལྟ་བ།_ཐ་དད་པ+འགྲེམ_ད་ལྟ་བ།_ཐ་དད་པ
འགྲེལ | འགྲེལ_ད་ལྟ་བ།_ཐ་དད་པ
འགྲེས | འགྲེ_འདས་པ།_ཐ་མི་དད་པ+འགྲེ_འདས་པ།_###
འགྲོ | འགྲོ_ད་ལྟ་བ།_###+འགྲོ_ད་ལྟ་བ།_ཐ་མི་དད་པ+སོང_ད་ལྟ་བ།_ཐ་མི་དད་པ+སོང_མ་འོངས་པ།_ཐ་མི་དད་པ+འགྲོ_མ་འོངས་པ།_###+འགྲོ_མ་འོངས་པ།_ཐ་མི་དད་པ
འགྲོག | འགྲོགས_ད་ལྟ་བ།_ཐ་མི་དད་པ+འགྲོགས_མ་འོངས་པ།_ཐ་མི་དད་པ
འགྲོགས | འགྲོགས_སྐུལ་ཚིག_ཐ་མི་དད་པ+འགྲོགས_འདས་པ།_ཐ་མི་དད་པ
འགྲོང | བྱ་ཚིག_ཐ་དད་པ+དགྲོང_དལྟབ_འབྲི་ཚུལ
འགྲོངས | བྱ་ཚིག_ཐ་མི་དད་པ+བཀྲོངས_དལྟབ_འབྲི་ཚུལ
འགྲོལ | འགྲོལ_ད་ལྟ་བ།_ཐ་དད་པ
འཆག | འཆག_མ་འོངས་པ།_ཐ་མི་དད་པ+འཆག_མ་འོངས་པ།_###+འཆག_ད་ལྟ་བ།_###+འཆག_ད་ལྟ་བ།_ཐ་མི་དད་པ
འཆགས | བཤགས_ད་ལྟ་བ།_འབྲི་ཚུལ
འཆང | འཆང_ད་ལྟ་བ།_ཐ་དད་པ+འཆང_ད་ལྟ་བ།_###+བཅང_ད་ལྟ་བ།_ཐ་དད་པ
འཆད | འཆད_ད་ལྟ་བ།_ཐ་དད་པ+འཆད_ད་ལྟ་བ།_ཐ་མི་དད་པ+བཤད_ད་ལྟ་བ།_ཐ་དད་པ+འཆད_མ་འོངས་པ།_ཐ་མི་དད་པ
འཆབ | འཆབ_ད་ལྟ་བ།_ཐ་དད་པ
འཆམ | འཆམ_ད་ལྟ་བ།_ཐ་མི་དད་པ+འཆམ_མ་འོངས་པ།_ཐ་དད་པ+འཆམ_མ་འོངས་པ།_ཐ་མི་དད་པ+འཆམ_ད་ལྟ་བ།_ཐ་དད་པ
འཆམས | འཆམ_འདས་པ།_ཐ་མི་དད་པ+འཆམ_འདས་པ།_ཐ་དད་པ
འཆའ | འཆའ_ད་ལྟ་བ།_ཐ་དད་པ+བཅའ_ད་ལྟ་བ།_ཐ་དད་པ+འཆའ_མ་འོངས་པ།_###+འཆོས_ད་ལྟ་བ།_###+འཆོས_མ་འོངས་པ།_###+འཆའ_ད་ལྟ་བ།_ཐ་མི་དད་པ+འཆའ_ད་ལྟ་བ།_###
འཆར | འཆར_ད་ལྟ་བ།_ཐ་མི་དད་པ+འཆར_ད་ལྟ་བ།_###+འཆར_མ་འོངས་པ།_###+འཆར_མ་འོངས་པ།_ཐ་མི་དད་པ
འཆལ | གཟུགས་མི་འགྱུར་བ_ཐ་མི་དད་པ+བྱ་ཚིག_###
འཆི | འཆི_ད་ལྟ་བ།_ཐ་མི་དད་པ+འཆི_མ་འོངས་པ།_###+འཆི_ད་ལྟ་བ།_###+འཆི_མ་འོངས་པ།_ཐ་མི་དད་པ
འཆིང | བཅིང_ད་ལྟ་བ།_ཐ་དད་པ+ཆིངས_ད་ལྟ་བ།_ཐ་དད་པ+འཆིང_ད་ལྟ་བ།_ཐ་དད་པ
འཆིབ | འཆིབ_ད་ལྟ་བ།_ཐ་དད་པ
འཆིར | འཆིར_ད་ལྟ་བ།_ཐ་དད་པ+འཆིར_ད་ལྟ་བ།_###
འཆུ | བཅུས_ད་ལྟ་བ།_ཐ་དད་པ+འཆུ_ད་ལྟ་བ།_ཐ་དད་པ+འཆུ_ད་ལྟ་བ།_###+འཆུ_ད་ལྟ་བ།_ཐ་མི་དད་པ+འཆུ_མ་འོངས་པ།_###+འཆུ_མ་འོངས་པ།_ཐ་མི་དད་པ
འཆུག | འཆུག_མ་འོངས་པ།_ཐ་མི་དད་པ+འཆུག_ད་ལྟ་བ།_ཐ་མི་དད་པ
འཆུགས | འཆུག_འདས་པ།_ཐ་མི་དད་པ
འཆུན | འཆུན_ད་ལྟ་བ།_ཐ་དད་པ+བྱ་ཚིག_###+འཇུན_འབྲི་ཚུལ
འཆུམ | འཆུམ_མ་འོངས་པ།_ཐ་དད་པ+འཆུམས_མ་འོངས་པ།_ཐ་དད་པ+འཆུམས_ད་ལྟ་བ།_ཐ་དད་པ+འཆུམ_ད་ལྟ་བ།_ཐ་དད་པ+འཆུམ_ད་ལྟ་བ།_ཐ་མི་དད་པ+འཆུམ_ད་ལྟ་བ།_###+འཆུམ_མ་འོངས་པ།_###+འཆུམ_མ་འོངས་པ།_ཐ་མི་དད་པ
འཆུམས | འཆུམ_འདས་པ།_ཐ་དད་པ+འཆུམ_འདས་པ།_###+འཆུམ_འདས་པ།_ཐ་མི་དད་པ+འཆུམས_འདས་པ།_ཐ་དད་པ+འཆུམ_སྐུལ་ཚིག_ཐ་དད་པ+འཆུམས_སྐུལ་ཚིག_ཐ་དད་པ
འཆུས | འཆུ_འདས་པ།_###+འཆུ_འདས་པ།_ཐ་མི་དད་པ
འཆེ | འཆེ_ད་ལྟ་བ།_ཐ་དད་པ+འཆེས_མ་འོངས་པ།_ཐ་དད་པ+འཆེ_མ་འོངས་པ།_ཐ་དད་པ+འཆེས_ད་ལྟ་བ།_ཐ་དད་པ
འཆེག | བྱ་ཚིག_ཐ་དད་པ
འཆེལ | བྱ་ཚིག_###+གཟུགས་མི་འགྱུར་བ_ཐ་དད་པ
འཆེས | འཆེ_སྐུལ་ཚིག_ཐ་དད་པ+འཆེས_འདས་པ།_ཐ་དད་པ+འཆེས_སྐུལ་ཚིག_ཐ་དད་པ+འཆེ_འདས་པ།_ཐ་དད་པ
འཆོ | བྱ་ཚིག_ཐ་དད་པ+འཆོས_འབྲི་ཚུལ
འཆོགས | བཤགས_སྐུལ་ཚིག_འབྲི་ཚུལ
འཆོབས | འཆབ_སྐུལ་ཚིག_འབྲི་ཚུལ
འཆོམས | འཆམ_སྐུལ་ཚིག_ཐ་དད་པ
འཆོར | འཆོར_མ་འོངས་པ།_###+འཆོར_མ་འོངས་པ།_ཐ་མི་དད་པ+འཆོར_ད་ལྟ་བ།_###+འཆོར_ད་ལྟ་བ།_ཐ་མི་དད་པ
འཆོལ | བཅོལ_སྐུལ་ཚིག_ཐ་དད་པ+གཟུགས་མི་འགྱུར་བ_ཐ་མི་དད་པ+འཆོལ_ད་ལྟ་བ།_ཐ་དད་པ+བཅོལ_ད་ལྟ་བ།_ཐ་དད་པ+འཆོལ_ད་ལྟ་བ།_###
འཆོས | འཆོས_ད་ལྟ་བ།_ཐ་དད་པ+འཆའ_སྐུལ་ཚིག_###+འཆོས_སྐུལ་ཚིག_###+འཆོས_འདས་པ།_###+བཅོས_ད་ལྟ་བ།_###+འཆའ_འདས་པ།_###+འཆོས_ད་ལྟ་བ།_###+ཆོས_ད་ལྟ་བ།_ཐ་དད་པ
འཇག | འཇག_ད་ལྟ་བ།_ཐ་དད་པ
འཇགས | གཅག_དལྟབ_འབྲི་ཚུལ+བྱ་ཚིག_ཐ་མི་དད་པ
འཇངས | འཇོང_འདས་པ།_ཐ་དད་པ
འཇབ | འཇབ_ད་ལྟ་བ།_ཐ་དད་པ
འཇབས | འཇབ_འདས་པ།_འབྲི་ཚུལ
འཇའ | ཞ_ད་ལྟ་བ།_འབྲི་ཚུལ+ཞ_མ་འོངས་པ།_འབྲི་ཚུལ
འཇར | བྱ་ཚིག_###+གཟུགས་མི་འགྱུར་བ_ཐ་དད་པ
འཇལ | འཇལ_ད་ལྟ་བ།_###+འཇལ_ད་ལྟ་བ།_ཐ་དད་པ
འཇས | ཞ_འདས་པ།_འབྲི་ཚུལ
འཇིག | འཇིག_ད་ལྟ་བ།_ཐ་མི་དད་པ+འཇིག_མ་འོངས་པ།_ཐ་མི་དད་པ+འཇིག_ད་ལྟ་བ།_ཐ་དད་པ
འཇིགས | གཟུགས་མི་འགྱུར་བ_ཐ་མི་དད་པ
འཇིབ | འཇིབ_ད་ལྟ་བ།_ཐ་དད་པ
འཇིབས | འཇིབ_སྐུལ་ཚིག_ཐ་དད་པ
འཇིལ | འཇིལ_ད་ལྟ་བ།_ཐ་དད་པ
འཇུ | འཇུས_ད་ལྟ་བ།_ཐ་དད་པ+འཇུས_མ་འོངས་པ།_ཐ་དད་པ+འཇུ_མ་འོངས་པ།_ཐ་དད་པ+འཇུ_ད་ལྟ་བ།_###+འཇུ_མ་འོངས་པ།_ཐ་མི་དད་པ+འཇུ_ད་ལྟ་བ།_ཐ་དད་པ+འཇུ_ད་ལྟ་བ།_ཐ་མི་དད་པ
འཇུག | འཇུག_ད་ལྟ་བ།_ཐ་དད་པ+འཇུག_ད་ལྟ་བ།_ཐ་མི་དད་པ+འཇུག_མ་འོངས་པ།_ཐ་མི་དད་པ
འཇུན | བྱ་ཚིག_###+འཇུན_ད་ལྟ་བ།_ཐ་དད་པ
འཇུམ | འཇུམ_ད་ལྟ་བ།_ཐ་དད་པ+འཇུམ_ད་ལྟ་བ།_ཐ་མི་དད་པ
འཇུར | འཇུར_ད་ལྟ་བ།_###+བྱ་ཚིག_###+གཟུགས་མི་འགྱུར་བ_ཐ་མི་དད་པ+འཇུར_ད་ལྟ་བ།_ཐ་དད་པ
འཇུས | འཇུས_འདས་པ།_ཐ་དད་པ+འཇུ_འདས་པ།_ཐ་དད་པ+འཇུ_སྐུལ་ཚིག_ཐ་དད་པ+འཇུས_སྐུལ་ཚིག_ཐ་དད་པ
འཇོ | གཟུགས་མི་འགྱུར་བ_ཐ་མི་དད་པ+འཇོ_ད་ལྟ་བ།_ཐ་དད་པ
འཇོག | འཇོག_ད་ལྟ་བ།_###+འཇོག_ད་ལྟ་བ།_ཐ་དད་པ
འཇོང | འཇོང_ད་ལྟ་བ།_ཐ་དད་པ+འཇོང_མ་འོངས་པ།_ཐ་དད་པ
འཇོངས | འཇོང_སྐུལ་ཚིག_ཐ་དད་པ
འཇོབ | འཇབ_སྐུལ་ཚིག_ཐ་དད་པ
འཇོམས | འཇོམས_ད་ལྟ་བ།_ཐ་དད་པ
འཇོལ | འཇལ_སྐུལ་ཚིག_###+བྱ་ཚིག_ཐ་མི་དད་པ+འཇལ_སྐུལ་ཚིག_ཐ་དད་པ
འཇོས | འཇོ_སྐུལཚིག_འབྲི་ཚུལ
འཐག | འཐག_ད་ལྟ་བ།_ཐ་དད་པ+བཏག_ད་ལྟ་བ།_ཐ་དད་པ+འཐག_ད་ལྟ་བ།_ཐ་མི་དད་པ+འཐག_མ་འོངས་པ།_ཐ་མི་དད་པ+འཐག_ད་ལྟ་བ།_###
འཐད | བྱ་ཚིག_###+གཟུགས་མི་འགྱུར་བ_ཐ་མི་དད་པ
འཐབ | འཐབ_མ་འོངས་པ།_###+འཐབ_ད་ལྟ་བ།_ཐ་དད་པ+འཐབ_མ་འོངས་པ།_ཐ་དད་པ+འཐབ_ད་ལྟ་བ།_###
འཐབས | འཐབ_འདས་པ།_###+འཐབ_འདས་པ།_ཐ་དད་པ
འཐམ | འཐམ_མ་འོངས་པ།_ཐ་མི་དད་པ+འཐམ_ད་ལྟ་བ།_ཐ་དད་པ+འཐམ_མ་འོངས་པ།_ཐ་དད་པ
འཐམས | འཐམ_འདས་པ།_ཐ་དད་པ+འཐམ_འདས་པ།_ཐ་མི་དད་པ+འཐམ_ད་ལྟ་བ།_ཐ་མི་དད་པ
འཐས | གཟུགས་མི་འགྱུར་བ_ཐ་མི་དད་པ
འཐིག | འཐིག_ད་ལྟ་བ།_ཐ་མི་དད་པ+འཐིག_མ་འོངས་པ།_ཐ་མི་དད་པ
འཐིགས | འཐིག_འདས་པ།_ཐ་མི་དད་པ
འཐིབ | འཐིབ_མ་འོངས་པ།_ཐ་མི་དད་པ+འཐིབ_ད་ལྟ་བ།_ཐ་མི་དད་པ
འཐིབས | འཐིབ_འདས་པ།_ཐ་མི་དད་པ
འཐིམ | འཐིམ_མ་འོངས་པ།_ཐ་མི་དད་པ+འཐིམ_ད་ལྟ་བ།_ཐ་མི་དད་པ
འཐུ | བཏུས_ད་ལྟ་བ།_ཐ་དད་པ+འཐུ_ད་ལྟ་བ།_ཐ་དད་པ
འཐུང | འཐུང_ད་ལྟ་བ།_ཐ་དད་པ
འཐུངས | འཐུང_སྐུལ་ཚིག_ཐ་དད་པ
འཐུད | མཐུད_འབྲི་ཚུལ+གཟུགས་མི་འགྱུར་བ_ཐ་དད་པ
འཐུམ | འཐུམ_ད་ལྟ་བ།_ཐ་དད་པ+ཐུམ_ད་ལྟ་བ།_ཐ་དད་པ
འཐུལ | གཟུགས་མི་འགྱུར་བ_ཐ་མི་དད་པ+ཐུལ_མ་འོངས་པ།_###+བྱ་ཚིག_###+ཐུལ_ད་ལྟ་བ།_###
འཐུས | འཐུ_སྐུལ་ཚིག_འབྲི་ཚུལ
འཐེང | འཐེང_ད་ལྟ་བ།_ཐ་མི་དད་པ+འཐེང_མ་འོངས་པ།_ཐ་མི་དད་པ
འཐེངས | འཐེང_འདས་པ།_ཐ་མི་དད་པ
འཐེན | གཟུགས་མི་འགྱུར་བ_ཐ་མི་དད་པ+བྱ་ཚིག_###
འཐེབ | འཐེབ_མ་འོངས་པ།_ཐ་མི་དད་པ+འཐེབ_ད་ལྟ་བ།_ཐ་མི་དད་པ
འཐེབས | འཐེབ_འདས་པ།_ཐ་མི་དད་པ
འཐེམ | འཐེམ_ད་ལྟ་བ།_ཐ་མི་དད་པ+བྱ་ཚིག_###+འཐེམ_མ་འོངས་པ།_ཐ་མི་དད་པ
འཐོག | འཐོག_ད་ལྟ་བ།_ཐ་དད་པ+འཐོག_ད་ལྟ་བ།_###+འཐོག_མ་འོངས་པ།_ཐ་མི་དད་པ+འཐོག_ད་ལྟ་བ།_ཐ་མི་དད་པ+འཐོག_མ་འོངས་པ།_###
འཐོགས | བཏག_སྐུལ་ཚིག_ཐ་དད་པ+འཐག_སྐུལ་ཚིག_ཐ་དད་པ+འཐོག_སྐུལ་ཚིག_###+འཐོག_སྐུལ་ཚིག_ཐ་དད་པ+འཐག_སྐུལ་ཚིག_###
འཐོན | ཐོན_ད་ལྟ་བ།_ཐ་མི་དད་པ+འཐོན_མ་འོངས་པ།_ཐ་མི་དད་པ+འཐོན_ད་ལྟ་བ།_ཐ་མི་དད་པ+ཐོན_མ་འོངས་པ།_ཐ་མི་དད་པ
འཐོབ | འཐོབ_མ་འོངས་པ།_ཐ་མི་དད་པ+འཐོབ_ད་ལྟ་བ།_ཐ་མི་དད་པ
འཐོབས | འཐབ_སྐུལ་ཚིག_ཐ་དད་པ+འཐབ_སྐུལ་ཚིག_###
འཐོམ | འཐོམ_ད་ལྟ་བ།_ཐ་དད་པ+འཐོམ_མ་འོངས་པ།_ཐ་དད་པ
འཐོམས | འཐམ_སྐུལ་ཚིག_ཐ་དད་པ+འཐོམ_འདས་པ།_ཐ་དད་པ
འཐོར | འཐོར_ད་ལྟ་བ།_ཐ་མི་དད་པ+འཐོར_མ་འོངས་པ།_ཐ་མི་དད་པ
འཐོལ | མཐོལ_འབྲི་ཚུལ+བྱ་ཚིག_ཐ་དད་པ
འདག | འདག_ད་ལྟ་བ།_ཐ་མི་དད་པ+འདག_མ་འོངས་པ།_ཐ་མི་དད་པ
འདང | འདང_ད་ལྟ་བ།_ཐ་མི་དད་པ+འདང_མ་འོངས་པ།_ཐ་མི་དད་པ
འདངས | འདང_འདས་པ།_ཐ་མི་དད་པ
འདམ | འདམ_ད་ལྟ་བ།_ཐ་དད་པ
འདའ | འདའ_མ་འོངས་པ།_###+འདའ_ད་ལྟ་བ།_###+འདའ_མ་འོངས་པ།_ཐ་མི་དད་པ+འདའ_ད་ལྟ་བ།_ཐ་མི་དད་པ
འདར | གཟུགས་མི་འགྱུར་བ_ཐ་མི་དད་པ
འདལ | གཟུགས་མི་འགྱུར་བ_ཐ་མི་དད་པ
འདས | འདའ_འདས་པ།_ཐ་མི་དད་པ+འདའ_འདས་པ།_###
འདིང | འདིང_ད་ལྟ་བ།_ཐ་དད་པ
འདུ | འདུ_མ་འོངས་པ།_###+འདུ_ད་ལྟ་བ།_ཐ་མི་དད་པ+འདུ_ད་ལྟ་བ།_###+འདུ_མ་འོངས་པ།_ཐ་མི་དད་པ
འདུག | གཟུགས་མི་འགྱུར་བ_ཐ་མི་དད་པ
འདུད | འདུད_ད་ལྟ་བ།_ཐ་དད་པ
འདུམ | འདུམ_ད་ལྟ་བ།_ཐ་མི་དད་པ+འདུམ_མ་འོངས་པ།_ཐ་མི་དད་པ
འདུམས | འདུམ_འདས་པ།_ཐ་མི་དད་པ
འདུར | གཟུགས་མི་འགྱུར་བ_ཐ་མི་དད་པ+བྱ་ཚིག_###
འདུལ | འདུལ_ད་ལྟ་བ།_###+འདུལ_ད་ལྟ་བ།_ཐ་དད་པ
འདུས | འདུ_འདས་པ།_ཐ་མི་དད་པ+འདུ_འདས་པ།_###
འདེགས | འདེགས_ད་ལྟ་བ།_ཐ་དད་པ
འདེད | འདེད_ད་ལྟ་བ།_###+འདེད_ད་ལྟ་བ།_ཐ་དད་པ+འདེད_མ་འོངས་པ།_###+དེད_མ་འོངས་པ།_###+འདེད_མ་འོངས་པ།_ཐ་དད་པ+དེད_ད་ལྟ་བ།_###
འདེབས | འདེབས_ད་ལྟ་བ།_ཐ་དད་པ+འདེབས_ད་ལྟ་བ།_###
འདེམ | འདེམ_ད་ལྟ་བ།_ཐ་དད་པ
འདོག | འདོག_ད་ལྟ་བ།_ཐ་དད་པ
འདོགས | འདོགས_ད་ལྟ་བ།_###+འདོགས_ད་ལྟ་བ།_ཐ་དད་པ
འདོང | འདོང_མ་འོངས་པ།_ཐ་མི་དད་པ+འདོང_ད་ལྟ་བ།_ཐ་མི་དད་པ+དེངས_མ་འོངས་པ།_ཐ་མི་དད་པ+དེངས_ད་ལྟ་བ།_ཐ་མི་དད་པ
འདོད | ཐོད_ད་ལྟ་བ།_ཐ་དད་པ+གཟུགས་མི་འགྱུར་བ_ཐ་དད་པ+འདོད_ད་ལྟ་བ།_###
འདོན | འདོན_ད་ལྟ་བ།_ཐ་དད་པ+འདོན_ད་ལྟ་བ།_###
འདོམ | གཟུགས་མི་འགྱུར་བ_ཐ་མི་དད་པ+འདེམ_སྐུལ་ཚིག_ཐ་དད་པ
འདོམས | གདམས_སྐུལ་ཚིག_ཐ་དད་པ+འདོམས_ད་ལྟ་བ།_ཐ་དད་པ+གདམས_ད་ལྟ་བ།_ཐ་དད་པ+འདོམས_སྐུལ་ཚིག_ཐ་དད་པ
འདོར | དོར_ད་ལྟ་བ།_ཐ་དད་པ+འདོར_ད་ལྟ་བ།_ཐ་དད་པ
འདོས | འདའ_སྐུལ་ཚིག_འབྲི་ཚུལ
འདྲ | འདྲ_ད་ལྟ་བ།_ཐ་དད་པ
འདྲད | འདྲད_མ་འོངས་པ།_ཐ་དད་པ+འདྲད_འདས་པ།_ཐ་དད་པ+འདྲད_ད་ལྟ་བ།_ཐ་དད་པ
འདྲལ | འདྲལ_ད་ལྟ་བ།_ཐ་མི་དད་པ+དྲལ_ད་ལྟ་བ།_ཐ་མི་དད་པ
འདྲི | དྲིས_ད་ལྟ་བ།_ཐ་དད་པ+འདྲི_ད་ལྟ་བ།_ཐ་དད་པ
འདྲིལ | འདྲིལ_ད་ལྟ་བ།_ཐ་དད་པ+དྲིལ_ད་ལྟ་བ།_ཐ་དད་པ+འདྲིལ_ད་ལྟ་བ།_###
འདྲིས | གཟུགས་མི་འགྱུར་བ_ཐ་མི་དད་པ+བྱ་ཚིག_###
འདྲུ | དྲུས_ད་ལྟ་བ།_ཐ་དད་པ+དྲུས_མ་འོངས་པ།_ཐ་དད་པ+འདྲུ_མ་འོངས་པ།_ཐ་དད་པ+འདྲུ_ད་ལྟ་བ།_ཐ་དད་པ
འདྲུད | འདྲུད_ད་ལྟ་བ།_ཐ་མི་དད་པ+འདྲུད_མ་འོངས་པ།_ཐ་དད་པ+དྲུད_ད་ལྟ་བ།_ཐ་མི་དད་པ+འདྲུད_ད་ལྟ་བ།_ཐ་དད་པ+དྲུད_མ་འོངས་པ།_ཐ་མི་དད་པ+འདྲུད_མ་འོངས་པ།_ཐ་མི་དད་པ
འདྲུབ | འདྲུབ_མ་འོངས་པ།_ཐ་མི་དད་པ+དྲུབས_མ་འོངས་པ།_ཐ་མི་དད་པ+འདྲུབ_ད་ལྟ་བ།_ཐ་མི་དད་པ+འདྲུབ_ད་ལྟ་བ།_ཐ་དད་པ+དྲུབས_ད་ལྟ་བ།_ཐ་དད་པ+འདྲུབ_མ་འོངས་པ།_ཐ་དད་པ+དྲུབས_ད་ལྟ་བ།_ཐ་མི་དད་པ
འདྲུབས | འདྲུབ_འདས་པ།_འབྲི་ཚུལ
འདྲུལ | འདྲུལ_ད་ལྟ་བ།_ཐ་དད་པ+དྲུལ_མ་འོངས་པ།_ཐ་དད་པ+འདྲུལ_མ་འོངས་པ།_ཐ་མི་དད་པ+འདྲུལ_མ་འོངས་པ།_ཐ་དད་པ+དྲུལ_ད་ལྟ་བ།_ཐ་དད་པ+འདྲུལ_ད་ལྟ་བ།_ཐ་མི་དད་པ
འདྲེ | འདྲེ_མ་འོངས་པ།_ཐ་མི་དད་པ+འདྲེ_ད་ལྟ་བ།_ཐ་མི་དད་པ
འདྲེགས | གཟུགས་མི་འགྱུར་བ_ཐ་མི་དད་པ
འདྲེད | བྱ་ཚིག_###+བྱ་ཚིག_ཐ་མི་དད་པ
འདྲེན | འདྲེན_ད་ལྟ་བ།_###+བགྲང_དལྟབ_འབྲི་ཚུལ+འདྲེན_ད་ལྟ་བ།_ཐ་དད་པ
འདྲེས | འདྲེ_འདས་པ།_ཐ་མི་དད་པ
འདྲོག | འདྲོག_མ་འོངས་པ།_ཐ་མི་དད་པ+འདྲོག_ད་ལྟ་བ།_ཐ་མི་དད་པ
འདྲོགས | འདྲོག_འདས་པ།_ཐ་མི་དད་པ
འདྲོང | འདྲོང_ད་ལྟ་བ།_ཐ་དད་པ+འདྲོང_མ་འོངས་པ།_ཐ་དད་པ+འདྲོངས_མ་འོངས་པ།_ཐ་དད་པ+འདྲོངས_ད་ལྟ་བ།_ཐ་དད་པ
འདྲོངས | འདྲོང_འདས་པ།_ཐ་དད་པ+འདྲོངས_སྐུལ་ཚིག_ཐ་དད་པ+འདྲོངས_འདས་པ།_ཐ་དད་པ+འདྲོང_སྐུལ་ཚིག_ཐ་དད་པ
འདྲོད | འདྲད_སྐུལ་ཚིག_ཐ་དད་པ
འཕག | འཕག_མ་འོངས་པ།_ཐ་མི་དད་པ+འཕག_མ་འོངས་པ།_###+འཕག_ད་ལྟ་བ།_###+འཕག_ད་ལྟ་བ།_ཐ་མི་དད་པ
འཕགས | གཟུགས་མི་འགྱུར་བ_###+འཕག_འདས་པ།_###+འཕག_འདས་པ།_ཐ་མི་དད་པ
འཕང | ཕང_འབྲི་ཚུལ+འཕོག_མ་འོངས་པ།_ཐ་མི་དད་པ+འཕེན_མ་འོངས་པ།_###+འཕེན_མ་འོངས་པ།_ཐ་དད་པ
འཕངས | འཕེན_འདས་པ།_###+འཕེན_འདས་པ།_ཐ་དད་པ
འཕམ | འཕམ_མ་འོངས་པ།_ཐ་མི་དད་པ+འཕམ_ད་ལྟ་བ།_ཐ་མི་དད་པ
འཕར | བྱ་ཚིག_###+གཟུགས་མི་འགྱུར་བ_ཐ་མི་དད་པ
འཕུང | ཕུང_ད་ལྟ་བ།_ཐ་དད་པ+འཕུང_མ་འོངས་པ།_ཐ་དད་པ+ཕུང_མ་འོངས་པ།_ཐ་དད་པ+འཕུང_ད་ལྟ་བ།_ཐ་དད་པ
འཕུད | ཕུད_ད་ལྟ་བ།_ཐ་དད་པ+འཕུད_མ་འོངས་པ།_ཐ་དད་པ+འཕུད_ད་ལྟ་བ།_ཐ་དད་པ+འཕུད_མ་འོངས་པ།_###+འཕུད_ད་ལྟ་བ།_###+ཕུད_མ་འོངས་པ།_ཐ་དད་པ
འཕུར | ཕུར_མ་འོངས་པ།_ཐ་མི་དད་པ+ཕུར_ད་ལྟ་བ།_ཐ་མི་དད་པ+འཕུར_ད་ལྟ་བ།_ཐ་མི་དད་པ+འཕུར_ད་ལྟ་བ།_###+འཕུར_མ་འོངས་པ།_###+འཕུར_མ་འོངས་པ།_ཐ་མི་དད་པ
འཕུལ | བྱ་ཚིག_###+བྱ་ཚིག_ཐ་དད་པ
འཕེན | འཕེན_ད་ལྟ་བ།_###+འཕེན_ད་ལྟ་བ།_ཐ་དད་པ
འཕེལ | གཟུགས་མི་འགྱུར་བ_ཐ་མི་དད་པ
འཕོ | འཕོ_མ་འོངས་པ།_###+འཕོ_མ་འོངས་པ།_ཐ་མི་དད་པ+འཕོ_ད་ལྟ་བ།_ཐ་མི་དད་པ+འཕོ_ད་ལྟ་བ།_###
འཕོག | འཕོག_ད་ལྟ་བ།_###+འཕོག_ད་ལྟ་བ།_ཐ་མི་དད་པ+འཕོག_མ་འོངས་པ།_###
འཕོགས | འཕག_སྐུལ་ཚིག_ཐ་མི་དད་པ
འཕོངས | འཕོངས_མ་འོངས་པ།_ཐ་མི་དད་པ+འཕོངས_ད་ལྟ་བ།_ཐ་མི་དད་པ+འཕེན_སྐུལ་ཚིག_###+འཕེན_སྐུལ་ཚིག_ཐ་དད་པ
འཕོས | འཕོ_འདས་པ།_ཐ་མི་དད་པ+འཕོ_འདས་པ།_###
འཕྱ | འཕྱ_ད་ལྟ་བ།_ཐ་དད་པ+འཕྱ_མ་འོངས་པ།_ཐ་དད་པ
འཕྱག | འཕྱག_ད་ལྟ་བ།_ཐ་དད་པ
འཕྱགས | འཕྱག_འདསཔ_འབྲི་ཚུལ+བྱ་ཚིག_ཐ་དད་པ
འཕྱང | འཕྱང_མ་འོངས་པ།_ཐ་མི་དད་པ+འཕྱང_ད་ལྟ་བ།_ཐ་མི་དད་པ
འཕྱངས | འཕྱང_འདས་པ།_ཐ་མི་དད་པ
འཕྱན | གཟུགས་མི་འགྱུར་བ_ཐ་མི་དད་པ+འཕྱན_མ་འོངས་པ།_###+འཕྱན_ད་ལྟ་བ།_###+འཕྱན_འདས་པ།_###
འཕྱར | ཕྱར_ད་ལྟ་བ།_ཐ་དད་པ+འཕྱར_ད་ལྟ་བ།_ཐ་དད་པ+འཕྱར_ད་ལྟ་བ།_###+འཕྱར_མ་འོངས་པ།_###
འཕྱས | འཕྱ_འདས་པ།_ཐ་དད་པ
འཕྱི | འཕྱི_ད་ལྟ་བ།_ཐ་མི་དད་པ+འཕྱི_མ་འོངས་པ།_ཐ་མི་དད་པ
འཕྱིང | འཕྱིང_མ་འོངས་པ།_ཐ་མི་དད་པ+འཕྱིང_ད་ལྟ་བ།_ཐ་མི་དད་པ
འཕྱིངས | འཕྱིང_འདས་པ།_ཐ་མི་དད་པ
འཕྱིད | འཕྱིད_ད་ལྟ་བ།_ཐ་མི་དད་པ+འཕྱིད_ད་ལྟ་བ།_###+འཕྱིད_མ་འོངས་པ།_ཐ་མི་དད་པ+འཕྱིད_མ་འོངས་པ།_###
འཕྱིས | འཕྱི_འདས་པ།_ཐ་མི་དད་པ
འཕྱུག | འཕྱུག_ད་ལྟ་བ།_ཐ་མི་དད་པ+འཕྱུག_མ་འོངས་པ།_ཐ་མི་དད་པ
འཕྱུགས | འཕྱུག_འདས་པ།_ཐ་མི་དད་པ
འཕྱུར | གཟུགས་མི་འགྱུར་བ_ཐ་མི་དད་པ
འཕྱེ | འཕྱེ_ད་ལྟ་བ།_ཐ་མི་དད་པ+འཕྱེ_མ་འོངས་པ།_ཐ་མི་དད་པ
འཕྱེས | འཕྱེ_འདས་པ།_ཐ་མི་དད་པ
འཕྱོ | འཕྱོ_མ་འོངས་པ།_###+འཕྱོ_མ་འོངས་པ།_ཐ་མི་དད་པ+འཕྱོ_ད་ལྟ་བ།_ཐ་མི་དད་པ+འཕྱོ_ད་ལྟ་བ།_###
འཕྱོགས | འཕྱག_སྐུལ་ཚིག_འབྲི་ཚུལ
འཕྱོང | འཕྱོང_ད་ལྟ་བ།_ཐ་མི་དད་པ+འཕྱོངས_མ་འོངས་པ།_###+འཕྱོང_མ་འོངས་པ།_ཐ་མི་དད་པ+བྱ་ཚིག_ཐ་དད་པ+འཕྱོངས_ད་ལྟ་བ།_###
འཕྱོངས | འཕྱོངས_འདས་པ།_###+འཕྱོང_སྐུལ་ཚིག_ཐ་མི་དད་པ+འཕྱོང_འདས་པ།_ཐ་མི་དད་པ+འཕྱང_སྐུལ་ཚིག_ཐ་མི་དད་པ+འཕྱོངས_སྐུལ་ཚིག_###
འཕྱོན | འཕྱན_སྐུལ་ཚིག_###
འཕྱོས | འཕྱོ_འདས་པ།_ཐ་མི་དད་པ+འཕྱོ_འདས་པ།_###+འཕྱ_སྐུལ་ཚིག_ཐ་དད་པ
འཕྲ | འཕྲ_མ་འོངས་པ།_ཐ་དད་པ+འཕྲ_ད་ལྟ་བ།_ཐ་དད་པ+ཕྲ_འབྲི་ཚུལ
འཕྲད | འཕྲད_ད་ལྟ་བ།_ཐ་མི་དད་པ+འཕྲད_མ་འོངས་པ།_ཐ་མི་དད་པ
འཕྲལ | འཕྲལ_ད་ལྟ་བ།_ཐ་དད་པ+ཕྲལ_ད་ལྟ་བ།_ཐ་དད་པ
འཕྲས | འཕྲ_འདས་པ།_ཐ་དད་པ
འཕྲི | འཕྲི_ད་ལྟ་བ།_ཐ་དད་པ
འཕྲིགས | བྱ་ཚིག_###+བྱ་ཚིག_ཐ་མི་དད་པ
འཕྲུ | བྱ་ཚིག_ཐ་དད་པ+ཕྲུ_འབྲི་ཚུལ
འཕྲུག | འཕྲུགས_མ་འོངས་པ།_ཐ་དད་པ+འཕྲུག_ད་ལྟ་བ།_ཐ་དད་པ+འཕྲུགས_ད་ལྟ་བ།_ཐ་དད་པ+འཕྲུག_མ་འོངས་པ།_ཐ་དད་པ
འཕྲུགས | འཕྲུག_སྐུལ་ཚིག_ཐ་དད་པ+འཕྲུག_འདས་པ།_ཐ་དད་པ+འཕྲུགས_སྐུལ་ཚིག_ཐ་དད་པ+འཕྲུགས_འདས་པ།_ཐ་དད་པ
འཕྲུལ | གཟུགས་མི་འགྱུར་བ_ཐ་མི་དད་པ
འཕྲེང | གཟུགས་མི་འགྱུར་བ_ཐ་མི་དད་པ
འཕྲོ | འཕྲོ_མ་འོངས་པ།_ཐ་མི་དད་པ+འཕྲོ_ད་ལྟ་བ།_###+འཕྲོ_མ་འོངས་པ།_###+འཕྲོ_ད་ལྟ་བ།_ཐ་མི་དད་པ
འཕྲོག | དབྲོག_ད་ལྟ་བ།_ཐ་དད་པ+ཕྲོགས_མ་འོངས་པ།_ཐ་དད་པ+ཕྲོགས_ད་ལྟ་བ།_ཐ་དད་པ+འཕྲོག_མ་འོངས་པ།_ཐ་དད་པ+འཕྲོག_ད་ལྟ་བ།_ཐ་དད་པ
འཕྲོད | བྱ་ཚིག_###+གཟུགས་མི་འགྱུར་བ_ཐ་མི་དད་པ
འཕྲོས | འཕྲོ_འདས་པ།_ཐ་མི་དད་པ+འཕྲོ_འདས་པ།_###
འབ | བྱ་ཚིག_ཐ་མི་དད་པ
འབག | འབག_ད་ལྟ་བ།_ཐ་མི་དད་པ+འབག_མ་འོངས་པ།_###+འབག_ད་ལྟ་བ།_###+འབག_མ་འོངས་པ།_ཐ་མི་དད་པ
འབགས | འབག_འདས་པ།_ཐ་མི་དད་པ+འབག_འདས་པ།_###
འབད | འབད_ད་ལྟ་བ།_ཐ་དད་པ+འབད_འདས་པ།_ཐ་དད་པ+འབད_མ་འོངས་པ།_ཐ་དད་པ
འབབ | འབབ_མ་འོངས་པ།_ཐ་མི་དད་པ+འབབ_ད་ལྟ་བ།_ཐ་མི་དད་པ+འབབ_མ་འོངས་པ།_###+འབབ_ད་ལྟ་བ།_###
འབར | གཟུགས་མི་འགྱུར་བ_ཐ་མི་དད་པ+བྱ་ཚིག_###
འབལ | འབལ_ད་ལྟ་བ།_ཐ་དད་པ+འབལ_མ་འོངས་པ།_ཐ་དད་པ
འབིག | འབིག_ད་ལྟ་བ།_ཐ་དད་པ
འབིགས | བྱ་ཚིག_ཐ་དད་པ+འབིག_འབྲི་ཚུལ
འབུ | འབུ_མ་འོངས་པ།_ཐ་མི་དད་པ+འབུ_ད་ལྟ་བ།_ཐ་མི་དད་པ
འབུག | བྱ་ཚིག_ཐ་དད་པ+འབིག_འབྲི་ཚུལ
འབུང | འབུངས_མ་འོངས་པ།_ཐ་དད་པ+འབུང_མ་འོངས་པ།_ཐ་དད་པ+འབུང_ད་ལྟ་བ།_ཐ་དད་པ+འབུངས_ད་ལྟ་བ།_ཐ་དད་པ
འབུངས | འབུངས_འདས་པ།_ཐ་དད་པ+འབུང_འདས་པ།_ཐ་དད་པ+འབུངས_སྐུལ་ཚིག_ཐ་དད་པ+འབུང_སྐུལ་ཚིག_ཐ་དད་པ
འབུད | བུས_ད་ལྟ་བ།_ཐ་དད་པ+འབུད_མ་འོངས་པ།_###+བུད_ད་ལྟ་བ།_ཐ་མི་དད་པ+བུས_མ་འོངས་པ།_ཐ་དད་པ+འབུད_མ་འོངས་པ།_ཐ་མི་དད་པ+འབུད_ད་ལྟ་བ།_###+བུད_མ་འོངས་པ།_ཐ་མི་དད་པ+འབུད_མ་འོངས་པ།_ཐ་དད་པ+འབུད_ད་ལྟ་བ།_ཐ་མི་དད་པ+འབུད_ད་ལྟ་བ།_ཐ་དད་པ
འབུབས | འབུབས_ད་ལྟ་བ།_###+ཕུབ_ད་ལྟ་བ།_ཐ་དད་པ+འབུབས_ད་ལྟ་བ།_ཐ་དད་པ
འབུར | གཟུགས་མི་འགྱུར་བ_ཐ་མི་དད་པ
འབུལ | འབུལ_ད་ལྟ་བ།_ཐ་དད་པ+ཕུལ_ད་ལྟ་བ།_ཐ་དད་པ
འབུས | འབུ_འདས་པ།_ཐ་མི་དད་པ
འབེབས | འབེབས_ད་ལྟ་བ།_ཐ་དད་པ+འབེབས_ད་ལྟ་བ།_###
འབོ | འབོ_ད་ལྟ་བ།_ཐ་དད་པ
འབོག | འབོག_མ་འོངས་པ།_ཐ་མི་དད་པ+འབོག_མ་འོངས་པ།_ཐ་དད་པ+འབོགས_ད་ལྟ་བ།_###+འབོགས_མ་འོངས་པ།_###+འབོག_ད་ལྟ་བ།_ཐ་མི་དད་པ+འབོག_ད་ལྟ་བ།_ཐ་དད་པ
འབོགས | འབོག_སྐུལ་ཚིག_ཐ་དད་པ+འབོགས_སྐུལ་ཚིག_###+འབོགས_ད་ལྟ་བ།_###+འབོག_འདས་པ།_ཐ་དད་པ+འབོགས_འདས་པ།_###+འབོག_འདས་པ།_ཐ་མི་དད་པ+འབོགས_ད་ལྟ་བ།_ཐ་དད་པ
འབོད | འབོད_ད་ལྟ་བ།_###+བོས_མ་འོངས་པ།_ཐ་དད་པ+བོས_ད་ལྟ་བ།_ཐ་དད་པ+འབོད_མ་འོངས་པ།_###+འབད_སྐུལ་ཚིག_ཐ་དད་པ
འབོར | འབོར_མ་འོངས་པ།_###+འབོར_ད་ལྟ་བ།_###+འབོར_མ་འོངས་པ།_ཐ་མི་དད་པ+འབོར_ད་ལྟ་བ།_ཐ་མི་དད་པ+བོར_ད་ལྟ་བ།_###+བོར_མ་འོངས་པ།_###
འབྱང | འབྱང_མ་འོངས་པ།_ཐ་མི་དད་པ+འབྱང_མ་འོངས་པ།_###+འབྱང_ད་ལྟ་བ།_###+འབྱང_ད་ལྟ་བ།_ཐ་མི་དད་པ
འབྱམ | འབྱམ_ད་ལྟ་བ།_ཐ་མི་དད་པ+འབྱམ_མ་འོངས་པ།_###+འབྱམ_ད་ལྟ་བ།_###+འབྱམ_མ་འོངས་པ།_ཐ་མི་དད་པ
འབྱམས | འབྱམ_འདས་པ།_ཐ་མི་དད་པ+འབྱམ_འདས་པ།_###
འབྱར | འབྱར_མ་འོངས་པ།_###+འབྱར_འདས་པ།_###+འབྱོར_འདས་པ།_###+འབྱར_ད་ལྟ་བ།_###
འབྱི | འབྱིད_མའོངསཔ_འབྲི་ཚུལ+བྱ་ཚིག_###+འབྱི_ད་ལྟ་བ།_ཐ་མི་དད་པ+འབྱི_མ་འོངས་པ།_ཐ་མི་དད་པ
འབྱིང | འབྱིང_མ་འོངས་པ།_###+འབྱིང_ད་ལྟ་བ།_###+འབྱིང_མ་འོངས་པ།_ཐ་མི་དད་པ+འབྱིང_ད་ལྟ་བ།_ཐ་མི་དད་པ
འབྱིད | འབྱིད_ད་ལྟ་བ།_ཐ་དད་པ+བྱ་ཚིག_###+འབྱིད_ད་ལྟ་བ།_ཐ་མི་དད་པ+འབྱིད_མ་འོངས་པ།_ཐ་མི་དད་པ+འབྱིད_ད་ལྟ་བ།_###
འབྱིན | འབྱིན_ད་ལྟ་བ།_ཐ་དད་པ+འབྱིན_ད་ལྟ་བ།_###
འབྱིབ | འབྱིབ_ད་ལྟ་བ།_ཐ་དད་པ+བྱིབས_མ་འོངས་པ།_ཐ་དད་པ+བྱིབས_ད་ལྟ་བ།_ཐ་དད་པ+འབྱིབ_མ་འོངས་པ།_ཐ་དད་པ
འབྱིལ | འབྱིལ_ད་ལྟ་བ།_ཐ་མི་དད་པ+འབྱིལ_མ་འོངས་པ།_ཐ་མི་དད་པ
འབྱུག | བྱུགས_ད་ལྟ་བ།_ཐ་དད་པ+འབྱུག_ད་ལྟ་བ།_ཐ་དད་པ
འབྱུང | འབྱུང_མ་འོངས་པ།_ཐ་མི་དད་པ+འབྱུང_ད་ལྟ་བ།_ཐ་མི་དད་པ
འབྱེ | འབྱེ_མ་འོངས་པ།_ཐ་དད་པ+འབྱེ_ད་ལྟ་བ།_ཐ་དད་པ
འབྱེད | འབྱེད_ད་ལྟ་བ།_###+འབྱེད_ད་ལྟ་བ།_ཐ་དད་པ
འབྱེར | འབྱེར_ད་ལྟ་བ།_ཐ་མི་དད་པ+འབྱེར_མ་འོངས་པ།_###+བྱེར_མ་འོངས་པ།_ཐ་མི་དད་པ+འབྱེར_མ་འོངས་པ།_ཐ་མི་དད་པ+འབྱེར_ད་ལྟ་བ།_###+བྱེར_ད་ལྟ་བ།_ཐ་མི་དད་པ
འབྱེས | གཟུགས་མི་འགྱུར་བ_ཐ་མི་དད་པ
འབྱོ | འབྱོ_མ་འོངས་པ།_ཐ་དད་པ+བྱོ_མ་འོངས་པ།_ཐ་དད་པ+འབྱོ_ད་ལྟ་བ།_ཐ་དད་པ+བྱོ_ད་ལྟ་བ།_ཐ་དད་པ
འབྱོག | འབྱོགས_མ་འོངས་པ།_ཐ་དད་པ+འབྱོག_མ་འོངས་པ།_ཐ་དད་པ+འབྱོག_ད་ལྟ་བ།_ཐ་དད་པ+འབྱོགས_ད་ལྟ་བ།_ཐ་དད་པ
འབྱོགས | འབྱོགས_འདས་པ།_ཐ་དད་པ+འབྱོག_འདས་པ།_ཐ་དད་པ+འབྱོག_སྐུལ་ཚིག_ཐ་དད་པ+འབྱོགས_སྐུལ་ཚིག_ཐ་དད་པ
འབྱོང | འབྱོང_ད་ལྟ་བ།_ཐ་དད་པ+འབྱོང_མ་འོངས་པ།_###+འབྱོངས_མ་འོངས་པ།_ཐ་མི་དད་པ+འབྱོང_མ་འོངས་པ།_ཐ་མི་དད་པ+འབྱོང_ད་ལྟ་བ།_###+འབྱོང_མ་འོངས་པ།_ཐ་དད་པ+འབྱོངས_ད་ལྟ་བ།_ཐ་མི་དད་པ+འབྱོང_ད་ལྟ་བ།_ཐ་མི་དད་པ
འབྱོངས | འབྱོང_འདས་པ།_ཐ་མི་དད་པ+འབྱོངས_འདས་པ།_ཐ་མི་དད་པ+འབྱོངས_སྐུལ་ཚིག_ཐ་མི་དད་པ+འབྱོང_སྐུལ་ཚིག_###+འབྱོང_འདས་པ།_###+འབྱོང_སྐུལ་ཚིག_ཐ་དད་པ+འབྱོང_འདས་པ།_ཐ་དད་པ
འབྱོན | བྱོན_མ་འོངས་པ།_ཐ་མི་དད་པ+འབྱོན_མ་འོངས་པ།_ཐ་དད་པ+བྱོན_ད་ལྟ་བ།_ཐ་མི་དད་པ+འབྱོན_ད་ལྟ་བ།_ཐ་དད་པ
འབྱོར | གཟུགས་མི་འགྱུར་བ_ཐ་མི་དད་པ+འབྱར_སྐུལ་ཚིག_###+བྱ་ཚིག_###+འབྱོར_ད་ལྟ་བ།_###+འབྱོར_མ་འོངས་པ།_###
འབྱོལ | བྱོལ_ད་ལྟ་བ།_ཐ་མི་དད་པ+འབྱོལ_ད་ལྟ་བ།_ཐ་མི་དད་པ
འབྲ | འབྲ_མ་འོངས་པ།_ཐ་དད་པ+འབྲ_ད་ལྟ་བ།_ཐ་དད་པ
འབྲང | འབྲང_མ་འོངས་པ།_ཐ་མི་དད་པ+འབྲང_ད་ལྟ་བ།_ཐ་མི་དད་པ
འབྲངས | འབྲང_འདས་པ།_ཐ་མི་དད་པ
འབྲད | འབྲད_ད་ལྟ་བ།_ཐ་དད་པ+འབྲད_ད་ལྟ་བ།_###
འབྲན | བྲན_ད་ལྟ་བ།_ཐ་དད་པ+འབྲན_ད་ལྟ་བ།_ཐ་དད་པ
འབྲབ | འབྲབ_ད་ལྟ་བ།_ཐ་དད་པ
འབྲལ | འབྲལ_མ་འོངས་པ།_ཐ་མི་དད་པ+འབྲལ_ད་ལྟ་བ།_ཐ་དད་པ+འབྲལ_ད་ལྟ་བ།_ཐ་མི་དད་པ
འབྲི | འབྲི_ད་ལྟ་བ།_ཐ་མི་དད་པ
འབྲིད | འབྲིད_ད་ལྟ་བ།_ཐ་དད་པ+བྲིད_མ་འོངས་པ།_ཐ་དད་པ+བྲིད_ད་ལྟ་བ།_ཐ་དད་པ+འབྲིད_མ་འོངས་པ།_ཐ་དད་པ
འབྲིམ | འབྲིམ_ད་ལྟ་བ།_ཐ་དད་པ
འབྲིམས | འབྲིམ_འདས་པ།_ཐ་དད་པ
འབྲུ | བྲུས_ད་ལྟ་བ།_ཐ་དད་པ+འབྲུ_ད་ལྟ་བ།_###+འབྲུ_ད་ལྟ་བ།_ཐ་དད་པ
འབྲུད | བྱ་ཚིག_ཐ་དད་པ+འབྲུ_འབྲི་ཚུལ
འབྲུབ | འབྲུབ_ད་ལྟ་བ།_ཐ་དད་པ+གཟུགས་མི་འགྱུར་བ_ཐ་མི་དད་པ+འབྲུབ_མ་འོངས་པ།_ཐ་དད་པ
འབྲུལ | འབྲུལ_ད་ལྟ་བ།_ཐ་མི་དད་པ+འབྲུལ_མ་འོངས་པ།_ཐ་མི་དད་པ
འབྲེག | འབྲེག_ད་ལྟ་བ།_ཐ་དད་པ
འབྲེལ | གཟུགས་མི་འགྱུར་བ_ཐ་མི་དད་པ
འབྲོ | འབྲོ_མ་འོངས་པ།_ཐ་མི་དད་པ+འབྲོ_ད་ལྟ་བ།_ཐ་མི་དད་པ
འབྲོང | འབྲང_འབྲི་ཚུལ+འབྲོངས_མ་འོངས་པ།_ཐ་མི་དད་པ+འབྲོང_ད་ལྟ་བ།_ཐ་དད་པ+འབྲོང_མ་འོངས་པ།_ཐ་དད་པ+བྱ་ཚིག_ཐ་མི་དད་པ+འབྲོངས_ད་ལྟ་བ།_ཐ་མི་དད་པ
འབྲོངས | འབྲོངས_འདས་པ།_ཐ་མི་དད་པ+འབྲོང_སྐུལ་ཚིག_ཐ་དད་པ+འབྲོངས_སྐུལ་ཚིག_ཐ་མི་དད་པ+འབྲོང_འདས་པ།_ཐ་དད་པ+འབྲང_སྐུལ་ཚིག_ཐ་མི་དད་པ
འབྲོབ | འབྲབ_འབྲི་ཚུལ+བྱ་ཚིག_ཐ་དད་པ
འབྲོས | བྲོས_ད་ལྟ་བ།_ཐ་མི་དད་པ+འབྲོ_འབྲི་ཚུལ+བྱ་ཚིག_ཐ་མི་དད་པ+བྲོས_མ་འོངས་པ།_ཐ་མི་དད་པ
འཚག | གཟུགས་མི་འགྱུར་བ_ཐ་མི་དད་པ+འཚག_ད་ལྟ་བ།_ཐ་དད་པ
འཚང | འཚང_ད་ལྟ་བ།_ཐ་དད་པ+འཚང_མ་འོངས་པ།_###+འཚང_ད་ལྟ་བ།_ཐ་མི་དད་པ+འཚང_ད་ལྟ་བ།_###
འཚངས | འཚང_འདས་པ།_###
འཚབ | འཚབ_མ་འོངས་པ།_ཐ་དད་པ+འཚབ_ད་ལྟ་བ།_ཐ་དད་པ
འཚབས | འཚབ_འདས་པ།_ཐ་དད་པ
འཚམ | འཚམ_ད་ལྟ་བ།_ཐ་མི་དད་པ+འཚམ_མ་འོངས་པ།_ཐ་མི་དད་པ
འཚམས | འཚམ_འདས་པ།_ཐ་མི་དད་པ
འཚར | གཟུགས་མི་འགྱུར་བ_ཐ་མི་དད་པ
འཚལ | བཙལ_ད་ལྟ་བ།_###+གཟུགས་མི་འགྱུར་བ_ཐ་དད་པ+འཚལ_འདས་པ།_ཐ་མི་དད་པ+བྱ་ཚིག_###+འཚལ_མ་འོངས་པ།_ཐ་མི་དད་པ+བཙལ_ད་ལྟ་བ།_ཐ་དད་པ+འཚལ_ད་ལྟ་བ།_ཐ་མི་དད་པ
འཚིག | འཚིག_མ་འོངས་པ།_ཐ་མི་དད་པ+འཚིག_ད་ལྟ་བ།_ཐ་མི་དད་པ+འཚིག_མ་འོངས་པ།_###+འཚིག_ད་ལྟ་བ།_###
འཚིར | བཙིར_ད་ལྟ་བ།_ཐ་དད་པ+འཚིར_ད་ལྟ་བ།_ཐ་དད་པ
འཚུད | འཚུད_ད་ལྟ་བ།_ཐ་མི་དད་པ+འཚུད_མ་འོངས་པ།_ཐ་མི་དད་པ
འཚུབ | འཚུབ_ད་ལྟ་བ།_ཐ་མི་དད་པ+འཚུབ_ད་ལྟ་བ།_###+འཚུབ_མ་འོངས་པ།_ཐ་མི་དད་པ+འཚུབ_མ་འོངས་པ།_###
འཚུབས | འཚུབ_འདས་པ།_ཐ་མི་དད་པ+འཚུབ_འདས་པ།_###
འཚུམ | འཚུམ_ད་ལྟ་བ།_ཐ་དད་པ+གཟུམ_ད་ལྟ་བ།_ཐ་དད་པ
འཚེ | བྱ་ཚིག_###+འཚེ_མ་འོངས་པ།_ཐ་དད་པ+འཚེ_ད་ལྟ་བ།_ཐ་དད་པ
འཚེག | གཟུགས་མི་འགྱུར་བ_ཐ་མི་དད་པ+བྱ་ཚིག_###
འཚེང | འཚེང_ད་ལྟ་བ།_ཐ་མི་དད་པ+འཚེང_མ་འོངས་པ།_ཐ་མི་དད་པ
འཚེངས | འཚེང_འདས་པ།_ཐ་མི་དད་པ
འཚེད | བྱ་ཚིག_ཐ་དད་པ+འཚོད_འབྲི་ཚུལ
འཚེམ | འཚེམ_ད་ལྟ་བ།_ཐ་དད་པ
འཚེམས | གཟུགས་མི་འགྱུར་བ_ཐ་མི་དད་པ+བྱ་ཚིག_###
འཚེར | བྱ་ཚིག_###+གཟུགས་མི་འགྱུར་བ_ཐ་མི་དད་པ
འཚེལ | འཚོལ_འབྲི་ཚུལ+བྱ་ཚིག_ཐ་དད་པ
འཚེས | འཚེ_འདས་པ།_ཐ་དད་པ+འཚེ_སྐུལ་ཚིག_ཐ་དད་པ
འཚོ | འཚོ_མ་འོངས་པ།_ཐ་དད་པ+གཟུགས་མི་འགྱུར་བ_ཐ་མི་དད་པ+འཚོས_ད་ལྟ་བ།_ཐ་དད་པ+འཚོ_ད་ལྟ་བ།_ཐ་དད་པ+འཚོས_མ་འོངས་པ།_ཐ་དད་པ
འཚོག | འཚོགས_མ་འོངས་པ།_ཐ་མི་དད་པ+འཚོག_ད་ལྟ་བ།_ཐ་མི་དད་པ+འཚོག_མ་འོངས་པ།_ཐ་མི་དད་པ+བྱ་ཚིག_###+འཚོགས_ད་ལྟ་བ།_ཐ་མི་དད་པ+འཚོག_ད་ལྟ་བ།_ཐ་དད་པ
འཚོགས | འཚོག_སྐུལ་ཚིག_ཐ་མི་དད་པ+འཚོགས_འདས་པ།_ཐ་མི་དད་པ+འཚོགས_སྐུལ་ཚིག_ཐ་མི་དད་པ+འཚོག_འདས་པ།_ཐ་མི་དད་པ
འཚོང | འཚོང_ད་ལྟ་བ།_ཐ་དད་པ
འཚོངས | འཚང_སྐུལ་ཚིག_###
འཚོད | འཚོད_ད་ལྟ་བ།_###+འཚོད_ད་ལྟ་བ།_ཐ་དད་པ
འཚོབ | གསོབ_འབྲི་ཚུལ+འཚོབ_མ་འོངས་པ།_ཐ་མི་དད་པ+བྱ་ཚིག_ཐ་དད་པ+འཚོབ_ད་ལྟ་བ།_ཐ་མི་དད་པ
འཚོབས | འཚབ_སྐུལ་ཚིག_འབྲི་ཚུལ
འཚོལ | འཚོལ_ད་ལྟ་བ།_ཐ་དད་པ+བཙལ_སྐུལ་ཚིག_###+འཚལ_སྐུལ་ཚིག_ཐ་མི་དད་པ+བཙལ_སྐུལ་ཚིག_ཐ་དད་པ+འཚོལ_སྐུལ་ཚིག_ཐ་དད་པ+འཚོལ_སྐུལ་ཚིག_###+འཚོལ_ད་ལྟ་བ།_###
འཚོས | འཚོས_སྐུལ་ཚིག_ཐ་དད་པ+འཚོ_སྐུལ་ཚིག_ཐ་དད་པ+འཚོས_འདས་པ།_ཐ་དད་པ+འཚོ_འདས་པ།_ཐ་དད་པ
འཛག | འཛག_མ་འོངས་པ།_ཐ་མི་དད་པ+འཛག_ད་ལྟ་བ།_ཐ་མི་དད་པ
འཛགས | བྱ་ཚིག_ཐ་དད་པ+འཚག_དལྟབ_འབྲི་ཚུལ
འཛད | འཛད_མ་འོངས་པ།_ཐ་མི་དད་པ+འཛད_ད་ལྟ་བ།_ཐ་མི་དད་པ
འཛའ | འཛའ_མ་འོངས་པ།_ཐ་མི་དད་པ+འཛའ_ད་ལྟ་བ།_ཐ་མི་དད་པ
འཛར | འཛར_ད་ལྟ་བ།_ཐ་དད་པ+འཛར_ད་ལྟ་བ།_ཐ་མི་དད་པ
འཛི | བྱ་ཚིག_ཐ་མི་དད་པ
འཛིང | འཛིང_མ་འོངས་པ།_ཐ་མི་དད་པ+འཛིང_ད་ལྟ་བ།_ཐ་དད་པ+འཛིངས_ད་ལྟ་བ།_ཐ་དད་པ+འཛིང_ད་ལྟ་བ།_###+འཛིང_མ་འོངས་པ།_###+འཛིངས_མ་འོངས་པ།_ཐ་དད་པ+འཛིང_མ་འོངས་པ།_ཐ་དད་པ+འཛིང_ད་ལྟ་བ།_ཐ་མི་དད་པ
འཛིངས | འཛིང_འདས་པ།_ཐ་མི་དད་པ+འཛིངས_འདས་པ།_ཐ་དད་པ+འཛིང_འདས་པ།_ཐ་དད་པ+འཛིང_སྐུལ་ཚིག_ཐ་དད་པ+འཛིངས_སྐུལ་ཚིག_ཐ་དད་པ+འཛིང_འདས་པ།_###
འཛིན | འཛིན_ད་ལྟ་བ།_###+འཛིན_ད་ལྟ་བ།_ཐ་དད་པ
འཛིར | གཟུགས་མི་འགྱུར་བ_ཐ་མི་དད་པ
འཛུགས | འཛུགས_ད་ལྟ་བ།_ཐ་དད་པ+འཛུགས_ད་ལྟ་བ།_###
འཛུད | འཛུད_ད་ལྟ་བ།_ཐ་དད་པ
འཛུམ | གཟུགས་མི་འགྱུར་བ_ཐ་མི་དད་པ+བྱ་ཚིག_ཐ་དད་པ
འཛུར | འཛུར_ད་ལྟ་བ།_ཐ་མི་དད་པ+གཟུགས་མི་འགྱུར་བ_ཐ་མི་དད་པ
འཛུལ | གཟུགས་མི་འགྱུར་བ_ཐ་མི་དད་པ+གཟུགས་མི་འགྱུར་བ_ཐ་དད་པ
འཛེག | འཛེག_མ་འོངས་པ།_ཐ་མི་དད་པ+འཛེག_ད་ལྟ་བ།_ཐ་མི་དད་པ+འཛེག_ད་ལྟ་བ།_ཐ་དད་པ+འཛེག_མ་འོངས་པ།_ཐ་དད་པ
འཛེགས | འཛེག_འདས་པ།_ཐ་མི་དད་པ+འཛེག_འདས་པ།_ཐ་དད་པ+འཛེག_སྐུལ་ཚིག_ཐ་མི་དད་པ+འཛེག_སྐུལ་ཚིག_ཐ་དད་པ
འཛེད | འཛེད_ད་ལྟ་བ།_ཐ་དད་པ
འཛེམ | འཛེམ_མ་འོངས་པ།_###+འཛེམ_མ་འོངས་པ།_ཐ་དད་པ+འཛེམ_ད་ལྟ་བ།_###+འཛེམས_ད་ལྟ་བ།_ཐ་དད་པ+འཛེམ_ད་ལྟ་བ།_ཐ་དད་པ+འཛེམས_མ་འོངས་པ།_ཐ་དད་པ
འཛེམས | འཛེམས_སྐུལ་ཚིག_ཐ་དད་པ+འཛེམ_འདས་པ།_ཐ་དད་པ+འཛེམ_སྐུལ་ཚིག_ཐ་དད་པ+འཛེམ_སྐུལ་ཚིག_###+འཛེམས_འདས་པ།_ཐ་དད་པ+འཛེམ_འདས་པ།_###
འཛེར | མཛེར_འབྲི་ཚུལ+གཟུགས་མི་འགྱུར་བ_ཐ་དད་པ
འཛོམ | འཛོམ_ད་ལྟ་བ།_ཐ་མི་དད་པ+འཛོམ_མ་འོངས་པ།_ཐ་མི་དད་པ+འཛོམས_མ་འོངས་པ།_ཐ་མི་དད་པ+འཛོམས_ད་ལྟ་བ།_ཐ་མི་དད་པ
འཛོམས | འཛོམས_འདས་པ།_ཐ་མི་དད་པ+འཛོམས_སྐུལ་ཚིག_ཐ་མི་དད་པ+འཛོམ_སྐུལ་ཚིག_ཐ་མི་དད་པ+འཛོམ_འདས་པ།_ཐ་མི་དད་པ
འཛོལ | གཟུགས་མི་འགྱུར་བ_ཐ་མི་དད་པ
འོང | འོང_ད་ལྟ་བ།_ཐ་མི་དད་པ+འོང_མ་འོངས་པ།_ཐ་མི་དད་པ+འོང_མ་འོངས་པ།_###+འོང_ད་ལྟ་བ།_###
འོངས | འོང_འདས་པ།_ཐ་མི་དད་པ+འོང_འདས་པ།_###
འོན | གཟུགས་མི་འགྱུར་བ_ཐ་མི་དད་པ
ཡན | གཟུགས་མི་འགྱུར་བ_ཐ་མི་དད་པ
ཡར | གཟུགས་མི་འགྱུར་བ_ཐ་མི་དད་པ
ཡལ | གཟུགས་མི་འགྱུར་བ_ཐ་མི་དད་པ+བྱ་ཚིག_###
ཡིབ | ཡིབས_མ་འོངས་པ།_ཐ་མི་དད་པ+ཡིབ_མ་འོངས་པ།_ཐ་མི་དད་པ+ཡིབ_ད་ལྟ་བ།_ཐ་མི་དད་པ+ཡིབས_ད་ལྟ་བ།_ཐ་མི་དད་པ
ཡིབས | ཡིབས_འདས་པ།_ཐ་མི་དད་པ+ཡིབ_འདས་པ།_ཐ་མི་དད་པ+ཡིབ_སྐུལ་ཚིག_ཐ་མི་དད་པ+ཡིབས_སྐུལ་ཚིག_ཐ་མི་དད་པ
ཡུར | གཟུགས་མི་འགྱུར་བ_ཐ་མི་དད་པ+གཟུགས་མི་འགྱུར་བ_ཐ་དད་པ
ཡེར | གཟུགས་མི་འགྱུར་བ_ཐ་མི་དད་པ+བྱ་ཚིག_###
ཡེལ | བྱ་ཚིག_ཐ་དད་པ+གཡེལ_འབྲི་ཚུལ
ཡོ | གཟུགས་མི་འགྱུར་བ_ཐ་མི་དད་པ
ཡོག | ཡོག_མ་འོངས་པ།_ཐ་དད་པ+ཡོག_ད་ལྟ་བ།_ཐ་དད་པ
ཡོགས | ཡོག_སྐུལ་ཚིག_ཐ་དད་པ+ཡོག_འདས་པ།_ཐ་དད་པ
ཡོང | གཟུགས་མི་འགྱུར་བ_ཐ་མི་དད་པ
ཡོལ | གཟུགས་མི་འགྱུར་བ_ཐ་མི་དད་པ
རག | གཟུགས་མི་འགྱུར་བ_ཐ་མི་དད་པ+བྱ་ཚིག_###
རངས | གཟུགས་མི་འགྱུར་བ_ཐ་མི་དད་པ
རན | གཟུགས་མི་འགྱུར་བ_ཐ་མི་དད་པ+བྱ་ཚིག_###
རལ | གཟུགས་མི་འགྱུར་བ_ཐ་མི་དད་པ
རིག | གཟུགས་མི་འགྱུར་བ_ཐ་དད་པ
རིད | གཟུགས་མི་འགྱུར་བ_ཐ་མི་དད་པ
རིལ | གཟུགས་མི་འགྱུར་བ_ཐ་མི་དད་པ
རུད | གཟུགས་མི་འགྱུར་བ_ཐ་མི་དད་པ
རུབ | རུབ_ད་ལྟ་བ།_ཐ་མི་དད་པ+རུབ_མ་འོངས་པ།_ཐ་དད་པ+རུབ_ད་ལྟ་བ།_###+རུབ_ད་ལྟ་བ།_ཐ་དད་པ+རུབ_མ་འོངས་པ།_###+རུབ_མ་འོངས་པ།_ཐ་མི་དད་པ
རུབས | རུབ_འདས་པ།_ཐ་མི་དད་པ+རུབ_འདས་པ།_###+རུབ_སྐུལ་ཚིག_ཐ་དད་པ+རུབ_འདས་པ།_ཐ་དད་པ
རུམ | གཟུགས་མི་འགྱུར་བ_ཐ་དད་པ
རུལ | གཟུགས་མི་འགྱུར་བ_ཐ་མི་དད་པ
རེ | གཟུགས་མི་འགྱུར་བ_ཐ་དད་པ
རེག | གཟུགས་མི་འགྱུར་བ_ཐ་མི་དད་པ+གཟུགས་མི་འགྱུར་བ_ཐ་དད་པ
རེད | གཟུགས་མི་འགྱུར་བ_ཐ་མི་དད་པ
རེམ | གཟུགས་མི་འགྱུར་བ_ཐ་མི་དད་པ
རོལ | གཟུགས་མི་འགྱུར་བ_ཐ་མི་དད་པ+གཟུགས་མི་འགྱུར་བ_ཐ་དད་པ
རྐམ | རྐམ_ད་ལྟ་བ།_ཐ་མི་དད་པ
རྐུ | རྐུས_ད་ལྟ་བ།_ཐ་དད་པ+རྐུ_ད་ལྟ་བ།_ཐ་དད་པ
རྐུས | རྐུ_སྐུལ་ཚིག_ཐ་དད་པ+རྐུས_སྐུལ་ཚིག_ཐ་དད་པ
རྐོ | རྐོས_ད་ལྟ་བ།_ཐ་དད་པ+རྐོ_ད་ལྟ་བ།_ཐ་དད་པ
རྐོམས | རྐམ_སྐུལ་ཚིག_འབྲི་ཚུལ
རྐོས | རྐོ_སྐུལ་ཚིག_ཐ་དད་པ+རྐོས_སྐུལ་ཚིག_ཐ་དད་པ
རྐྱལ | རྐྱལ_མ་འོངས་པ།_ཐ་དད་པ+རྐྱལ_ད་ལྟ་བ།_ཐ་དད་པ+རྐྱལ_འདས་པ།_ཐ་དད་པ
རྐྱོང | རྐྱོང_ད་ལྟ་བ།_ཐ་དད་པ
རྐྱོངས | རྐྱོང_སྐུལ་ཚིག_ཐ་དད་པ
རྐྱོལ | རྐྱལ_སྐུལ་ཚིག_ཐ་དད་པ
རྒ | རྒ_ད་ལྟ་བ།_ཐ་མི་དད་པ+རྒ_མ་འོངས་པ།_ཐ་མི་དད་པ
རྒལ | རྒལ_ད་ལྟ་བ།_ཐ་མི་དད་པ+རྒལ_ད་ལྟ་བ།_ཐ་དད་པ+རྒལ_ད་ལྟ་བ།_###
རྒས | རྒ_འདས་པ།_ཐ་མི་དད་པ
རྒུད | གཟུགས་མི་འགྱུར་བ_ཐ་དད་པ
རྒོལ | བརྒལ_ད་ལྟ་བ།_ཐ་དད་པ+བརྒལ_སྐུལ་ཚིག_ཐ་དད་པ+རྒལ_སྐུལ་ཚིག_###+གཟུགས་མི་འགྱུར་བ_ཐ་དད་པ+རྒལ_སྐུལ་ཚིག_ཐ་དད་པ
རྒྱ | རྒྱ_ད་ལྟ་བ།_ཐ་མི་དད་པ+རྒྱ_མ་འོངས་པ།_ཐ་མི་དད་པ
རྒྱག | རྒྱག_ད་ལྟ་བ།_ཐ་དད་པ+རྒྱག_ད་ལྟ་བ།_###
རྒྱགས | རྒྱགས_ད་ལྟ་བ།_ཐ་མི་དད་པ+རྒྱགས_ད་ལྟ་བ།_###
རྒྱན | རྒྱན_ད་ལྟ་བ།_ཐ་དད་པ+རྒྱན_སྐུལ་ཚིག_ཐ་དད་པ+བརྒྱན_ད་ལྟ་བ།_ཐ་དད་པ
རྒྱལ | གཟུགས་མི་འགྱུར་བ_ཐ་མི་དད་པ
རྒྱས | རྒྱ_འདས་པ།_ཐ་མི་དད་པ+གཟུགས་མི་འགྱུར་བ_ཐ་མི་དད་པ
རྒྱུ | གཟུགས་མི་འགྱུར་བ_ཐ་མི་དད་པ+བྱ་ཚིག_ཐ་དད་པ
རྒྱུག | རྒྱུག_ད་ལྟ་བ།_ཐ་མི་དད་པ+རྒྱུག_ད་ལྟ་བ།_###
རྒྱུགས | རྒྱུག_སྐུལ་ཚིག_ཐ་མི་དད་པ+རྒྱུག_སྐུལ་ཚིག_###
རྒྱུང | རྒྱུང_ད་ལྟ་བ།_ཐ་དད་པ+བྱ་ཚིག_###
རྒྱུངས | རྒྱུང_སྐུལ་ཚིག_ཐ་དད་པ
རྒྱུད | རྒྱུད_ད་ལྟ་བ།_ཐ་དད་པ
རྒྱུས | རྒྱུད_སྐུལ་ཚིག_ཐ་དད་པ
རྒྱོ | རྒྱོ_ད་ལྟ་བ།_ཐ་དད་པ
རྒྱོགས | རྒྱག_སྐུལ་ཚིག_###
རྒྱོང | རྒྱོང_ད་ལྟ་བ།_ཐ་མི་དད་པ
རྒྱོངས | རྒྱོང_སྐུལ་ཚིག_ཐ་མི་དད་པ
རྒྱོན | བརྒྱན_སྐུལ་ཚིག_ཐ་དད་པ
རྒྱོབ | རྒྱག_སྐུལ་ཚིག_###+རྒྱག_སྐུལ་ཚིག_ཐ་དད་པ
རྒྱོས | རྒྱོ_སྐུལ་ཚིག_ཐ་དད་པ
རྔ | རྔ_ད་ལྟ་བ།_ཐ་དད་པ
རྔན | རྔན_ད་ལྟ་བ།_###+རྔན_ད་ལྟ་བ།_ཐ་དད་པ
རྔབ | རྔབ_ད་ལྟ་བ།_ཐ་མི་དད་པ
རྔམ | རྔམ_ད་ལྟ་བ།_ཐ་དད་པ+རྔམ_ད་ལྟ་བ།_ཐ་མི་དད་པ+བརྔམས_ད་ལྟ་བ།_ཐ་དད་པ
རྔུབ | རྔུབ_ད་ལྟ་བ།_ཐ་དད་པ
རྔུབས | རྔུབ_སྐུལ་ཚིག_ཐ་དད་པ
རྔུལ | གཟུགས་མི་འགྱུར་བ_ཐ་མི་དད་པ
རྔོད | རྔོད_ད་ལྟ་བ།_###+རྔོད_སྐུལ་ཚིག_ཐ་དད་པ+རྔོད_ད་ལྟ་བ།_ཐ་དད་པ+བརྔོད_ད་ལྟ་བ།_ཐ་དད་པ+རྔོས_ད་ལྟ་བ།_###+བརྔོད_སྐུལ་ཚིག_ཐ་དད་པ
རྔོན | རྔན_སྐུལ་ཚིག_ཐ་དད་པ+བརྔན_སྐུལ་ཚིག_ཐ་དད་པ+རྔོན_ད་ལྟ་བ།_###+རྔོན_སྐུལ་ཚིག_###+བརྔོན_སྐུལ་ཚིག_ཐ་དད་པ+རྔན_སྐུལ་ཚིག_###+བརྔོན_ད་ལྟ་བ།_ཐ་དད་པ+བརྔན_ད་ལྟ་བ།_ཐ་དད་པ
རྔོམས | བརྔམས_སྐུལ་ཚིག_ཐ་དད་པ+རྔམ_སྐུལ་ཚིག_ཐ་དད་པ
རྔོས | རྔོད_སྐུལ་ཚིག_###+རྔ_སྐུལ་ཚིག_ཐ་དད་པ+རྔོད_སྐུལ་ཚིག_ཐ་དད་པ+རྔོས_སྐུལ་ཚིག_###
རྗེ | རྗེ_ད་ལྟ་བ།_ཐ་དད་པ
རྗེད | རྗེད_ད་ལྟ་བ།_ཐ་དད་པ+བརྗེད_སྐུལ་ཚིག_###+རྗེད_སྐུལ་ཚིག_ཐ་དད་པ+བརྗེད_ད་ལྟ་བ།_ཐ་དད་པ+རྗེད_ད་ལྟ་བ།_ཐ་མི་དད་པ+བརྗེད_ད་ལྟ་བ།_###
རྗེས | རྗེ_སྐུལ་ཚིག_ཐ་དད་པ
རྗོད | རྗོད_ད་ལྟ་བ།_ཐ་དད་པ+རྗོད_སྐུལ་ཚིག_ཐ་དད་པ+བརྗོད_ད་ལྟ་བ།_ཐ་དད་པ+བརྗོད_སྐུལ་ཚིག_ཐ་དད་པ
རྙ | རྙ_ད་ལྟ་བ།_ཐ་དད་པ
རྙང | རྙང_ད་ལྟ་བ།_ཐ་དད་པ
རྙབ | རྙབ_ད་ལྟ་བ།_ཐ་དད་པ
རྙིང | རྙིང_ད་ལྟ་བ།_ཐ་མི་དད་པ+བརྙིང_ད་ལྟ་བ།_ཐ་མི་དད་པ
རྙིད | གཟུགས་མི་འགྱུར་བ_ཐ་མི་དད་པ+བྱ་ཚིག_###
རྙེད | གཟུགས་མི་འགྱུར་བ_ཐ་དད་པ
རྙོག | རྙོག_ད་ལྟ་བ།_ཐ་དད་པ
རྙོགས | རྙོག_སྐུལ་ཚིག_ཐ་དད་པ
རྙོང | རྙོང_ད་ལྟ་བ།_ཐ་དད་པ+རྙོང_ད་ལྟ་བ།_###+རྙོང_ད་ལྟ་བ།_ཐ་མི་དད་པ
རྙོངས | རྙང_སྐུལ་ཚིག_ཐ་དད་པ+རྙོང_སྐུལ་ཚིག_ཐ་དད་པ+རྙོང_སྐུལ་ཚིག_###
རྙོན | རྙོན_སྐུལ་ཚིག_ཐ་དད་པ+བརྙན_ད་ལྟ་བ།_ཐ་དད་པ+བརྙན_སྐུལ་ཚིག_ཐ་དད་པ+རྙོན_ད་ལྟ་བ།_ཐ་དད་པ
རྙོབ | གཟུགས་མི་འགྱུར་བ_ཐ་མི་དད་པ
རྙོབས | རྙབ_སྐུལ་ཚིག_ཐ་དད་པ
རྙོས | རྙ_སྐུལ་ཚིག_ཐ་དད་པ
རྟབ | རྟབ_ད་ལྟ་བ།_ཐ་མི་དད་པ
རྟས | རྟས_ད་ལྟ་བ།_ཐ་མི་དད་པ
རྟིབས | རྟིབ_སྐུལ་ཚིག_འབྲི་ཚུལ
རྟུན | བརྟུན_སྐུལ་ཚིག_ཐ་དད་པ+བརྟུན_ད་ལྟ་བ།_ཐ་དད་པ+རྟུན_སྐུལ་ཚིག_ཐ་དད་པ+རྟུན_ད་ལྟ་བ།_ཐ་དད་པ
རྟུལ | རྟུལ_སྐུལ་ཚིག_ཐ་དད་པ+རྟུལ_ད་ལྟ་བ།_ཐ་དད་པ+བརྟུལ_སྐུལ་ཚིག_ཐ་དད་པ+བརྟུལ_ད་ལྟ་བ།_ཐ་དད་པ+རྟུལ_སྐུལ་ཚིག_###+རྟུལ_ད་ལྟ་བ།_###
རྟེན | རྟེན_ད་ལྟ་བ།_ཐ་མི་དད་པ+རྟེན_སྐུལ་ཚིག_ཐ་མི་དད་པ+བརྟེན_ད་ལྟ་བ།_ཐ་དད་པ+བརྟེན_སྐུལ་ཚིག_ཐ་དད་པ
རྟོག | རྟོག_ད་ལྟ་བ།_ཐ་དད་པ
རྟོགས | གཟུགས་མི་འགྱུར་བ_ཐ་མི་དད་པ+རྟོག_སྐུལ་ཚིག_ཐ་དད་པ
རྟོད | བརྟོད_སྐུལ་ཚིག_ཐ་དད་པ+བརྟོད_ད་ལྟ་བ།_ཐ་དད་པ+རྟོད_ད་ལྟ་བ།_ཐ་དད་པ+རྟོད_སྐུལ་ཚིག_ཐ་དད་པ
རྟོན | བརྟན_ད་ལྟ་བ།_ཐ་དད་པ+རྟོན_ད་ལྟ་བ།_ཐ་དད་པ+བརྟན_སྐུལ་ཚིག_ཐ་དད་པ+རྟོན_སྐུལ་ཚིག_ཐ་དད་པ
རྟོལ | རྟོལ_སྐུལ་ཚིག_###+བརྟོལ_སྐུལ་ཚིག_ཐ་དད་པ+རྟོལ_ད་ལྟ་བ།_ཐ་དད་པ+བརྟོལ_ད་ལྟ་བ།_ཐ་དད་པ+རྟོལ_ད་ལྟ་བ།_ཐ་མི་དད་པ+རྟོལ_སྐུལ་ཚིག_ཐ་དད་པ+རྟོལ_ད་ལྟ་བ།_###
རྡབ | རྡབ_ད་ལྟ་བ།_ཐ་མི་དད་པ
རྡར | རྡར_ད་ལྟ་བ།_ཐ་དད་པ+བརྡར_ད་ལྟ་བ།_ཐ་དད་པ+རྡར_ད་ལྟ་བ།_###
རྡལ | བརྡལ_ད་ལྟ་བ།_ཐ་དད་པ+རྡལ_ད་ལྟ་བ།_ཐ་དད་པ
རྡིབ | རྡིབ_ད་ལྟ་བ།_ཐ་མི་དད་པ+བརྡིབས_ད་ལྟ་བ།_ཐ་མི་དད་པ+རྡིབ_ད་ལྟ་བ།_###
རྡིབས | བརྡིབས_སྐུལ་ཚིག_ཐ་མི་དད་པ
རྡུགས | གཟུགས་མི་འགྱུར་བ_ཐ་མི་དད་པ
རྡུང | རྡུང_ད་ལྟ་བ།_###+རྡུང_ད་ལྟ་བ།_ཐ་དད་པ
རྡུངས | རྡུང_སྐུལ་ཚིག_###+རྡུང_སྐུལ་ཚིག_ཐ་དད་པ
རྡེག | རྡེག_ད་ལྟ་བ།_ཐ་དད་པ
རྡེགས | རྡེག_སྐུལ་ཚིག_ཐ་དད་པ
རྡེབ | རྡེབ_ད་ལྟ་བ།_###+རྡེབ_ད་ལྟ་བ།_ཐ་དད་པ
རྡེབས | རྡེབ_སྐུལཚིག_འབྲི་ཚུལ
རྡོབས | རྡེབ_སྐུལ་ཚིག_ཐ་དད་པ
རྡོར | བརྡར_སྐུལ་ཚིག_ཐ་དད་པ+རྡར_སྐུལ་ཚིག_###+རྡར_སྐུལ་ཚིག_ཐ་དད་པ
རྡོལ | རྡོལ_ད་ལྟ་བ།_###+རྡོལ_ད་ལྟ་བ།_ཐ་མི་དད་པ+རྡལ_སྐུལ་ཚིག_ཐ་དད་པ+བརྡོལ_ད་ལྟ་བ།_ཐ་མི་དད་པ+བརྡལ_སྐུལ་ཚིག_ཐ་དད་པ
རྡོས | གཟུགས་མི་འགྱུར་བ_ཐ་མི་དད་པ
རྣག | རྣག_མ་འོངས་པ།_ཐ་མི་དད་པ+རྣག_ད་ལྟ་བ།_ཐ་མི་དད་པ
རྣགས | རྣག_འདས་པ།_ཐ་མི་དད་པ
རྣབ | རྣབ_ད་ལྟ་བ།_ཐ་དད་པ
རྣུ | རྣུ_ད་ལྟ་བ།_ཐ་དད་པ
རྣུར | རྣུ_སྐུལ་ཚིག_ཐ་དད་པ
རྣོག | རྣོག_ད་ལྟ་བ།_ཐ་དད་པ+རྣོག_ད་ལྟ་བ།_###
རྣོགས | རྣོག_སྐུལ་ཚིག_ཐ་དད་པ+རྣོག_སྐུལ་ཚིག_###
རྣོང | རྣོང_ད་ལྟ་བ།_ཐ་དད་པ
རྣོན | རྣོན_སྐུལ་ཚིག_ཐ་དད་པ+རྣོན_ད་ལྟ་བ།_ཐ་དད་པ+བརྣན_སྐུལ་ཚིག_ཐ་དད་པ+བརྣན_ད་ལྟ་བ།_ཐ་དད་པ
རྣོབས | རྣབ_སྐུལ་ཚིག_ཐ་དད་པ
རྦད | རྦོད_མ་འོངས་པ།_ཐ་དད་པ+རྦད_འདས་པ།_ཐ་དད་པ+རྦོད_འདས་པ།_ཐ་དད་པ+རྦད_མ་འོངས་པ།_ཐ་དད་པ
རྦོ | སྦོ_འབྲི་ཚུལ+བྱ་ཚིག_ཐ་དད་པ
རྦོད | རྦད_ད་ལྟ་བ།_ཐ་དད་པ+རྦོད_ད་ལྟ་བ།_ཐ་དད་པ+རྦད_སྐུལ་ཚིག_ཐ་དད་པ+རྦོད_སྐུལ་ཚིག_ཐ་དད་པ
རྦོས | བྱ་ཚིག_ཐ་དད་པ+སྦོས_འབྲི་ཚུལ
རྨད | རྨད_མ་འོངས་པ།_ཐ་དད་པ+རྨད_འདས་པ།_ཐ་དད་པ+རྨེད_མ་འོངས་པ།_ཐ་དད་པ+རྨེད_འདས་པ།_ཐ་དད་པ
རྨས | བྱ་ཚིག_###+རྨེད_འདསཔ_འབྲི་ཚུལ+གཟུགས་མི་འགྱུར་བ_ཐ་དད་པ
རྨི | རྨི_ད་ལྟ་བ།_ཐ་མི་དད་པ+རྨི_མ་འོངས་པ།_ཐ་མི་དད་པ
རྨིས | རྨི_འདས་པ།_ཐ་མི་དད་པ
རྨུག | རྨུག_ད་ལྟ་བ།_ཐ་དད་པ+རྨུགས_ད་ལྟ་བ།_ཐ་དད་པ+རྨུགས_མ་འོངས་པ།_ཐ་དད་པ+རྨུག_མ་འོངས་པ།_ཐ་དད་པ
རྨུགས | རྨུག_འདས་པ།_ཐ་དད་པ+རྨུགས_འདས་པ།_ཐ་དད་པ+རྨུགས_སྐུལ་ཚིག_ཐ་དད་པ+རྨུག_སྐུལ་ཚིག_ཐ་དད་པ
རྨུར | གཟུགས་མི་འགྱུར་བ_ཐ་དད་པ
རྨུས | གཟུགས་མི་འགྱུར་བ_ཐ་མི་དད་པ+དམུས_འབྲི་ཚུལ
རྨེ | བྱ་ཚིག_ཐ་མི་དད་པ
རྨེད | རྨད_སྐུལ་ཚིག_ཐ་དད་པ+རྨད_ད་ལྟ་བ།_ཐ་དད་པ+རྨེད_ད་ལྟ་བ།_ཐ་དད་པ+རྨེད_སྐུལ་ཚིག_ཐ་དད་པ+རྨོད_སྐུལཚིག_འབྲི་ཚུལ
རྨེལ | གཟུགས་མི་འགྱུར་བ_ཐ་དད་པ
རྨོ | རྨོད_མ་འོངས་པ།_ཐ་དད་པ+རྨོས_མ་འོངས་པ།_ཐ་དད་པ
རྨོངས | གཟུགས་མི་འགྱུར་བ_ཐ་མི་དད་པ+བྱ་ཚིག_###
རྨོད | རྨོས_ད་ལྟ་བ།_ཐ་དད་པ+རྨོད_ད་ལྟ་བ།_ཐ་དད་པ
རྨོན | རྨོ_དལྟབ_འབྲི་ཚུལ+བྱ་ཚིག_ཐ་དད་པ
རྨོས | རྨོད_འདས་པ།_ཐ་དད་པ+རྨོད_སྐུལ་ཚིག_ཐ་དད་པ+རྨོས_འདས་པ།_ཐ་དད་པ+རྨོས_སྐུལ་ཚིག_ཐ་དད་པ
རྨྱ | རྨྱ_མ་འོངས་པ།_ཐ་མི་དད་པ+རྨྱ_ད་ལྟ་བ།_ཐ་མི་དད་པ
རྨྱང | རྨྱོང_མ་འོངས་པ།_ཐ་དད་པ
རྨྱངས | རྨྱོང_འདས་པ།_ཐ་དད་པ
རྨྱས | རྨྱ_འདས་པ།_ཐ་མི་དད་པ
རྨྱོང | རྨྱོང_ད་ལྟ་བ།_ཐ་དད་པ
རྨྱོངས | རྨྱོང_སྐུལ་ཚིག_ཐ་དད་པ
རྩི | རྩི_ད་ལྟ་བ།_ཐ་དད་པ
རྩིག | རྩིག_ད་ལྟ་བ།_ཐ་དད་པ
རྩིགས | རྩིག_སྐུལ་ཚིག_ཐ་དད་པ
རྩིས | རྩི_སྐུལ་ཚིག_ཐ་དད་པ
རྩེ | རྩེ_ད་ལྟ་བ།_ཐ་མི་དད་པ
རྩེག | རྩེག_ད་ལྟ་བ།_###+རྩེག_ད་ལྟ་བ།_ཐ་དད་པ
རྩེགས | རྩེག_སྐུལ་ཚིག_ཐ་དད་པ+རྩེག_སྐུལ་ཚིག_###
རྩེང | རྩེང_ད་ལྟ་བ།_###+རྩེང_ད་ལྟ་བ།_ཐ་དད་པ
རྩེངས | རྩེང_སྐུལ་ཚིག_ཐ་དད་པ+རྩེང_སྐུལ་ཚིག_###
རྩེན | གཟུགས་མི་འགྱུར་བ_ཐ་མི་དད་པ+བྱ་ཚིག_###
རྩེལ | སྩེལ_འབྲི་ཚུལ+བྱ་ཚིག_ཐ་དད་པ
རྩེས | རྩེ_སྐུལ་ཚིག_ཐ་མི་དད་པ
རྩོད | བརྩད_སྐུལ་ཚིག_ཐ་དད་པ+རྩོད_སྐུལ་ཚིག_ཐ་དད་པ+བརྩད_ད་ལྟ་བ།_ཐ་དད་པ+རྩོད_ད་ལྟ་བ།_ཐ་དད་པ
རྩོམ | རྩོམ_ད་ལྟ་བ།_ཐ་དད་པ+རྩོམ_ད་ལྟ་བ།_###
རྩོམས | རྩོམ_སྐུལ་ཚིག_ཐ་དད་པ+རྩོམ_སྐུལ་ཚིག_###
རྩོལ | བརྩལ_ད་ལྟ་བ།_ཐ་དད་པ+བརྩལ_སྐུལ་ཚིག_ཐ་དད་པ
རྫི | རྫི_ད་ལྟ་བ།_ཐ་དད་པ+རྫི_ད་ལྟ་བ།_###
རྫིས | རྫི_སྐུལ་ཚིག_###+རྫི_སྐུལ་ཚིག_ཐ་དད་པ
རྫུ | རྫུ_ད་ལྟ་བ།_ཐ་དད་པ
རྫུས | རྫུ_སྐུལ་ཚིག_ཐ་དད་པ
རྫེ | རྫེ_ད་ལྟ་བ།_ཐ་དད་པ
རྫེས | རྫེ_སྐུལ་ཚིག_ཐ་དད་པ
རྫོ | རྫོ_ད་ལྟ་བ།_ཐ་དད་པ
རྫོག | རྫོག_ད་ལྟ་བ།_ཐ་དད་པ+རྫོག_ད་ལྟ་བ།_###
རྫོགས | རྫོག_སྐུལ་ཚིག_ཐ་དད་པ+རྫོག_སྐུལ་ཚིག_###+བྱ་ཚིག_###
རྫོང | རྫོང_ད་ལྟ་བ།_ཐ་དད་པ+རྫོང_ད་ལྟ་བ།_###
རྫོངས | རྫོང_སྐུལ་ཚིག_ཐ་དད་པ+རྫོང_སྐུལ་ཚིག_###
རྫོད | རྫོད_སྐུལ་ཚིག_ཐ་དད་པ+རྫོད_ད་ལྟ་བ།_ཐ་དད་པ
རྫོས | རྫོ_སྐུལ་ཚིག_ཐ་དད་པ
རླག | རླག_ད་ལྟ་བ།_ཐ་དད་པ+བརླགས_ད་ལྟ་བ།_ཐ་དད་པ+རླག_ད་ལྟ་བ།_###
རླིང | རླིང_ད་ལྟ་བ།_ཐ་མི་དད་པ
རླིངས | རླིང_སྐུལ་ཚིག_ཐ་མི་དད་པ
རླུག | རླུགས_མ་འོངས་པ།_ཐ་མི་དད་པ+རླུགས_ད་ལྟ་བ།_ཐ་མི་དད་པ
རླུགས | རླུགས_འདས་པ།_ཐ་མི་དད་པ
རློ | རློ_ད་ལྟ་བ།_ཐ་མི་དད་པ+རློ_མ་འོངས་པ།_ཐ་མི་དད་པ
རློག | རླག_འབྲི་ཚུལ+བྱ་ཚིག_ཐ་དད་པ
རློགས | བརླགས_སྐུལ་ཚིག_ཐ་དད་པ+རླག_སྐུལ་ཚིག_ཐ་དད་པ+རླག_སྐུལ་ཚིག_###
རློང | རློང_ད་ལྟ་བ།_ཐ་དད་པ
རློངས | རློང_སྐུལ་ཚིག_ཐ་དད་པ
རློན | བརླན_ད་ལྟ་བ།_ཐ་དད་པ+བརླན_སྐུལ་ཚིག_ཐ་དད་པ+རློན_ད་ལྟ་བ།_ཐ་དད་པ+རློན_སྐུལ་ཚིག_ཐ་དད་པ
རློབ | རློབས_མ་འོངས་པ།_###+རློབ_ད་ལྟ་བ།_###+རློབས_ད་ལྟ་བ།_###+རློབ_མ་འོངས་པ།_###+རློབ_ད་ལྟ་བ།_ཐ་དད་པ
རློབས | རློབ_སྐུལ་ཚིག_ཐ་དད་པ+རློབས_སྐུལ་ཚིག_###+རློབས_འདས་པ།_###+རློབ_འདས་པ།_###+རློབ_སྐུལ་ཚིག_###
རློམ | གཟུགས་མི་འགྱུར་བ_ཐ་མི་དད་པ+རློམ_ད་ལྟ་བ།_ཐ་དད་པ
རློམས | རློམ_སྐུལ་ཚིག_ཐ་དད་པ
རློས | རློ_འདས་པ།_ཐ་མི་དད་པ
ལང | ལང_ད་ལྟ་བ།_###+ལང_ད་ལྟ་བ།_ཐ་མི་དད་པ+ལང_མ་འོངས་པ།_###+ལང_མ་འོངས་པ།_ཐ་མི་དད་པ
ལངས | ལང_འདས་པ།_###+ལང_འདས་པ།_ཐ་མི་དད་པ+ལྡང_འདས་པ།_###
ལད | གཟུགས་མི་འགྱུར་བ_ཐ་མི་དད་པ
ལབ | ལབ_ད་ལྟ་བ།_ཐ་དད་པ+ལབ_མ་འོངས་པ།_ཐ་དད་པ+ལབ_འདས་པ།_ཐ་དད་པ
ལས | ལས_ད་ལྟ་བ།_ཐ་དད་པ+ལས_མ་འོངས་པ།_ཐ་དད་པ+ལས_འདས་པ།_ཐ་དད་པ
ལུ | ལུ_མ་འོངས་པ།_ཐ་མི་དད་པ+ལུས_མ་འོངས་པ།_ཐ་མི་དད་པ+ལུས_ད་ལྟ་བ།_ཐ་མི་དད་པ+ལུ_ད་ལྟ་བ།_ཐ་མི་དད་པ
ལུག | ལུག_མ་འོངས་པ།_ཐ་དད་པ+ལུག_མ་འོངས་པ།_ཐ་མི་དད་པ+ལུག_ད་ལྟ་བ།_ཐ་དད་པ+ལུག_ད་ལྟ་བ།_ཐ་མི་དད་པ+ལུགས_ད་ལྟ་བ།_ཐ་དད་པ+ལུགས_མ་འོངས་པ།_ཐ་དད་པ
ལུགས | ལུག_འདས་པ།_ཐ་མི་དད་པ+ལུག_འདས་པ།_ཐ་དད་པ+ལུགས_འདས་པ།_ཐ་དད་པ+ལུགས_སྐུལ་ཚིག_ཐ་དད་པ
ལུད | གཟུགས་མི་འགྱུར་བ_ཐ་མི་དད་པ
ལུས | ལུས_སྐུལ་ཚིག_ཐ་མི་དད་པ+ལུས_འདས་པ།_ཐ་མི་དད་པ+ལུ_སྐུལ་ཚིག_ཐ་མི་དད་པ+གཟུགས་མི་འགྱུར་བ_###+ལུ_འདས་པ།_ཐ་མི་དད་པ
ལེན | ལེན_ད་ལྟ་བ།_###+ལེན_ད་ལྟ་བ།_ཐ་དད་པ
ལོག | གཟུགས་མི་འགྱུར་བ_ཐ་མི་དད་པ+བྱ་ཚིག_###
ལོང | ལོང_ད་ལྟ་བ།_ཐ་མི་དད་པ+ལོང_མ་འོངས་པ།_###+ལོང_མ་འོངས་པ།_ཐ་མི་དད་པ+ལོང_ད་ལྟ་བ།_###
ལོངས | ལོང_འདས་པ།_ཐ་མི་དད་པ+ལེན_སྐུལ་ཚིག_ཐ་དད་པ+ལང_སྐུལ་ཚིག_ཐ་མི་དད་པ+ལེན_སྐུལ་ཚིག_###+ལོང_འདས་པ།_###
ལོན | བྱ་ཚིག_###+གཟུགས་མི་འགྱུར་བ_ཐ་མི་དད་པ
ལོབ | ལོབ_མ་འོངས་པ།_###+ལོབ_ད་ལྟ་བ།_###+ལོབ_ད་ལྟ་བ།_ཐ་མི་དད་པ+ལབ_སྐུལ་ཚིག_ཐ་དད་པ+ལོབ_མ་འོངས་པ།_ཐ་མི་དད་པ
ལོབས | ལོབ_འདས་པ།_###+ལོབ_འདས་པ།_ཐ་མི་དད་པ
ལོས | ལས_སྐུལ་ཚིག_ཐ་དད་པ
ལྐུགས | གཟུགས་མི་འགྱུར་བ_ཐ་མི་དད་པ
ལྕིགས | བྱ་ཚིག_###+གཟུགས་མི་འགྱུར་བ_ཐ་དད་པ
ལྕིབས | གཟུགས་མི་འགྱུར་བ_ཐ་དད་པ
ལྕེབ | ལྕེབ_ད་ལྟ་བ།_ཐ་མི་དད་པ+ལྕེབ_མ་འོངས་པ།_ཐ་མི་དད་པ+ལྕེབས_ད་ལྟ་བ།_ཐ་མི་དད་པ+ལྕེབས_མ་འོངས་པ།_ཐ་མི་དད་པ
ལྕེབས | ལྕེབ_འདས་པ།_ཐ་མི་དད་པ+ལྕེབས_སྐུལ་ཚིག_ཐ་མི་དད་པ+ལྕེབ_སྐུལ་ཚིག_ཐ་མི་དད་པ+ལྕེབས_འདས་པ།_ཐ་མི་དད་པ
ལྟ | ལྟ_ད་ལྟ་བ།_ཐ་དད་པ+ལྟ_ད་ལྟ་བ།_###
ལྟབ | ལྟབ_ད་ལྟ་བ།_ཐ་དད་པ
ལྟམ | ལྟམ_ད་ལྟ་བ།_ཐ་མི་དད་པ+བལྟམས_ད་ལྟ་བ།_###
ལྟིར | བྱ་ཚིག_ཐ་མི་དད་པ
ལྟུང | ལྟུང_ད་ལྟ་བ།_ཐ་མི་དད་པ+ལྟུང_མ་འོངས་པ།_ཐ་མི་དད་པ
ལྟུངས | ལྟུང_འདས་པ།_ཐ་མི་དད་པ
ལྟེབ | ལྟེབ_ད་ལྟ་བ།_ཐ་དད་པ
ལྟེབས | ལྟེབ_སྐུལ་ཚིག_ཐ་དད་པ
ལྟེམ | ལྟེམ_ད་ལྟ་བ།_###+ལྟེམ_ད་ལྟ་བ།_ཐ་མི་དད་པ
ལྟེམས | ལྟེམ_སྐུལ་ཚིག_ཐ་མི་དད་པ
ལྟོགས | གཟུགས་མི་འགྱུར་བ_ཐ་མི་དད་པ
ལྟོབས | ལྟབ_སྐུལ་ཚིག_ཐ་དད་པ
ལྟོམས | ལྟམ_སྐུལ་ཚིག_ཐ་མི་དད་པ+ལྟེམ_སྐུལཚིག_འབྲི་ཚུལ
ལྟོས | གཟུགས་མི་འགྱུར་བ_ཐ་མི་དད་པ+ལྟ_སྐུལ་ཚིག_ཐ་དད་པ+ལྟ_སྐུལ་ཚིག_###
ལྡག | བལྡགས_ད་ལྟ་བ།_ཐ་དད་པ+ལྡག_ད་ལྟ་བ།_ཐ་དད་པ
ལྡང | གཟུགས་མི་འགྱུར་བ_ཐ་མི་དད་པ+ལྡང_མ་འོངས་པ།_###+བྱ་ཚིག_###+ལྡང_ད་ལྟ་བ།_###
ལྡངས | ལྡང_འདས་པ།_###
ལྡད | བལྡད_ད་ལྟ་བ།_ཐ་དད་པ+ལྡད_ད་ལྟ་བ།_ཐ་དད་པ
ལྡབ | ལྡོབས_ད་ལྟ་བ།_ཐ་དད་པ+ལྡབ_ད་ལྟ་བ།_ཐ་དད་པ
ལྡར | གཟུགས་མི་འགྱུར་བ_ཐ་མི་དད་པ
ལྡིག | གཟུགས་མི་འགྱུར་བ_ཐ་དད་པ
ལྡིང | ལྡིང_མ་འོངས་པ།_###+ལྡིང_ད་ལྟ་བ།_ཐ་མི་དད་པ+ལྡིང_ད་ལྟ་བ།_###+ལྡིང_མ་འོངས་པ།_ཐ་མི་དད་པ
ལྡིངས | ལྡིང_འདས་པ།_###+ལྡིང_འདས་པ།_ཐ་མི་དད་པ
ལྡུག | ལྡུག_ད་ལྟ་བ།_ཐ་དད་པ+ལྡུག_མ་འོངས་པ།_ཐ་དད་པ+ལྡུགས_མ་འོངས་པ།_ཐ་དད་པ+ལྡུགས_ད་ལྟ་བ།_ཐ་དད་པ
ལྡུགས | ལྡུགས_འདས་པ།_ཐ་དད་པ+ལྡུག_འདས་པ།_ཐ་དད་པ+ལྡུག_སྐུལ་ཚིག_ཐ་དད་པ+ལྡུགས_སྐུལ་ཚིག_ཐ་དད་པ
ལྡུད | བླུད_ད་ལྟ་བ།_ཐ་དད་པ+ལྡུད_མ་འོངས་པ།_ཐ་དད་པ+བླུད_མ་འོངས་པ།_ཐ་དད་པ+ལྡུད_ད་ལྟ་བ།_ཐ་དད་པ
ལྡུར | གཟུགས་མི་འགྱུར་བ_ཐ་མི་དད་པ
ལྡེ | ལྡེ_མ་འོངས་པ།_ཐ་དད་པ+ལྡེས_ད་ལྟ་བ།_ཐ་མི་དད་པ+ལྡེ_ད་ལྟ་བ།_ཐ་དད་པ+ལྡེས_མ་འོངས་པ།_ཐ་མི་དད་པ
ལྡེག | ལྡེག_ད་ལྟ་བ།_ཐ་དད་པ+ལྡེག_ད་ལྟ་བ།_ཐ་མི་དད་པ
ལྡེགས | ལྡེག_སྐུལ་ཚིག_ཐ་དད་པ
ལྡེང | ལྡེང_ད་ལྟ་བ།_ཐ་མི་དད་པ+ལྡེང_མ་འོངས་པ།_ཐ་མི་དད་པ
ལྡེངས | ལྡེང_འདས་པ།_ཐ་མི་དད་པ
ལྡེབ | བལྡབས_ད་ལྟ་བ_འབྲི་ཚུལ
ལྡེམ | གཟུགས་མི་འགྱུར་བ_ཐ་མི་དད་པ
ལྡེས | ལྡེ_འདས་པ།_ཐ་དད་པ+ལྡེས_སྐུལ་ཚིག_ཐ་མི་དད་པ+ལྡེས_འདས་པ།_ཐ་མི་དད་པ+ལྡེ_སྐུལ་ཚིག_ཐ་དད་པ
ལྡོག | བྱ་ཚིག_###+གཟུགས་མི་འགྱུར་བ_ཐ་མི་དད་པ
ལྡོགས | བལྡགས_སྐུལ་ཚིག_ཐ་དད་པ+ལྡག_སྐུལ་ཚིག_ཐ་དད་པ
ལྡོང | ལྡོང_ད་ལྟ་བ།_ཐ་མི་དད་པ+ལྡོང_མ་འོངས་པ།_ཐ་མི་དད་པ
ལྡོངས | ལྡིང_སྐུལ་ཚིག_ཐ་མི་དད་པ+ལྡོང_འདས་པ།_ཐ་མི་དད་པ+ལྡང_སྐུལ་ཚིག_###
ལྡོད | བལྡད_སྐུལ་ཚིག_ཐ་དད་པ+ལྡད_སྐུལ་ཚིག_ཐ་དད་པ
ལྡོན | གཟུགས་མི་འགྱུར་བ_ཐ་དད་པ
ལྡོབ | ལྡོབ_མ་འོངས་པ།_ཐ་མི་དད་པ+ལྡོབ_ད་ལྟ་བ།_ཐ་མི་དད་པ
ལྡོབས | ལྡོབ_འདས་པ།_ཐ་མི་དད་པ+ལྡབ_སྐུལ་ཚིག_ཐ་དད་པ+ལྡོབས_སྐུལ་ཚིག_ཐ་དད་པ
ལྡོམ | གཟུགས་མི་འགྱུར་བ_ཐ་མི་དད་པ
ལྦོས | བྱ་ཚིག_ཐ་མི་དད་པ+སྦོས_འབྲི་ཚུལ
ལྷགས | གཟུགས་མི་འགྱུར་བ_ཐ་མི་དད་པ
ལྷུག | ལྷུག_མ་འོངས་པ།_ཐ་མི་དད་པ+ལྷུག_ད་ལྟ་བ།_ཐ་མི་དད་པ
ལྷུགས | ལྷུག_འདས་པ།_ཐ་མི་དད་པ+བླུག_སྐུལཚིག_འབྲི་ཚུལ
ལྷུང | གཟུགས་མི་འགྱུར་བ_ཐ་མི་དད་པ
ལྷོགས | བྱ་ཚིག_###
ལྷོང | ལྷོང_ད་ལྟ་བ།_###+ལྷོང_མ་འོངས་པ།_###+ལྷོང_མ་འོངས་པ།_ཐ་མི་དད་པ+ལྷོང_ད་ལྟ་བ།_ཐ་མི་དད་པ
ལྷོངས | ལྷོང_འདས་པ།_ཐ་མི་དད་པ+ལྷོང_འདས་པ།_###
ལྷོད | གཟུགས་མི་འགྱུར་བ_ཐ་མི་དད་པ
ལྷོན | གཟུགས་མི་འགྱུར་བ_ཐ་དད་པ
ཤན | བྱ་ཚིག_###+བྱ་ཚིག_ཐ་དད་པ
ཤབ | ཤབ_ད་ལྟ་བ།_ཐ་དད་པ+ཤབ_མ་འོངས་པ།_ཐ་དད་པ
ཤབས | ཤབ_འདས་པ།_ཐ་དད་པ
ཤར | འཆར_འདས་པ།_ཐ་མི་དད་པ+འཆར_འདས་པ།_###
ཤི | འཆི_འདས་པ།_ཐ་མི་དད་པ+འཆི_འདས་པ།_###
ཤིག | འཇིག_སྐུལ་ཚིག_ཐ་དད་པ+ཤིག_ད་ལྟ་བ།_ཐ་དད་པ
ཤིགས | ཤིག_སྐུལ་ཚིག_ཐ་དད་པ
ཤིང | བྱ་ཚིག_ཐ་མི་དད་པ
ཤིས | གཟུགས་མི་འགྱུར་བ_ཐ་མི་དད་པ
ཤུག | ཤུག_ད་ལྟ་བ།_ཐ་དད་པ
ཤུགས | ཤུག_སྐུལ་ཚིག_ཐ་དད་པ
ཤུངས | གཤུང_སྐུལ་ཚིག_ཐ་དད་པ
ཤུད | གཟུགས་མི་འགྱུར་བ_ཐ་མི་དད་པ+བཤུད_སྐུལ་ཚིག_ཐ་དད་པ
ཤུབ | ཤུབ_ད་ལྟ་བ།_ཐ་དད་པ
ཤུབས | ཤུབ_སྐུལ་ཚིག_ཐ་དད་པ
ཤུམ | ཤུམ_ད་ལྟ་བ།_ཐ་མི་དད་པ+ཤུམས_ད་ལྟ་བ།_ཐ་མི་དད་པ
ཤུམས | ཤུམས_སྐུལ་ཚིག_ཐ་མི་དད་པ+ཤུམ_སྐུལ་ཚིག_ཐ་མི་དད་པ
ཤུར | གཤུར_སྐུལ་ཚིག_ཐ་དད་པ+བཤུར_སྐུལ་ཚིག_ཐ་དད་པ
ཤུས | བཤུ_སྐུལ་ཚིག_###+བཤུ_སྐུལ་ཚིག_ཐ་དད་པ
ཤེར | བཤེར_སྐུལ་ཚིག_ཐ་དད་པ+གཤེར_སྐུལ་ཚིག_###
ཤེས | གཟུགས་མི་འགྱུར་བ_ཐ་མི་དད་པ+བྱ་ཚིག_###
ཤོ | གཟུགས་མི་འགྱུར་བ_ཐ་མི་དད་པ
ཤོག | གཟུགས་མི་འགྱུར་བ_ཐ་མི་དད་པ
ཤོགས | འཆགས_སྐུལ་ཚིག_འབྲི་ཚུལ
ཤོང | གཟུགས་མི་འགྱུར་བ_ཐ་མི་དད་པ
ཤོངས | གཤོང_སྐུལཚིག_འབྲི་ཚུལ
ཤོད | འཆད_སྐུལ་ཚིག_ཐ་དད་པ+བཤད_སྐུལ་ཚིག_ཐ་དད་པ
ཤོབས | ཤབ_སྐུལ་ཚིག_ཐ་དད་པ
ཤོམ | གཤོམ_འབྲི་ཚུལ+བྱ་ཚིག_ཐ་དད་པ
ཤོམས | གཤོམ_སྐུལ་ཚིག_ཐ་དད་པ+གཤོམ_སྐུལ་ཚིག_###
ཤོར | འཆོར_འདས་པ།_###+འཆོར_འདས་པ།_ཐ་མི་དད་པ
ཤོལ | བཤལ_སྐུལ་ཚིག_###+བཤལ_སྐུལ་ཚིག_ཐ་དད་པ
ཤོས | གཤོ_སྐུལ་ཚིག_ཐ་དད་པ
སངས | གཟུགས་མི་འགྱུར་བ_ཐ་མི་དད་པ
སད | གཟུགས་མི་འགྱུར་བ_ཐ་མི་དད་པ
སིགས | གསིག_སྐུལ་ཚིག_ཐ་དད་པ
སིམ | གཟུགས་མི་འགྱུར་བ_ཐ་མི་དད་པ+བྱ་ཚིག_###
སུན | བསུན_ད་ལྟ་བ།_ཐ་མི་དད་པ+སུན_ད་ལྟ་བ།_ཐ་མི་དད་པ
སུབ | སུབ_ད་ལྟ་བ།_ཐ་དད་པ
སུབས | སུབ_སྐུལ་ཚིག_ཐ་དད་པ
སུམ | སུམ_ད་ལྟ་བ།_ཐ་དད་པ
སུམས | སུམ_སྐུལ་ཚིག_ཐ་དད་པ
སུས | བསུ_སྐུལ་ཚིག_འབྲི་ཚུལ
སེག | གཟུགས་མི་འགྱུར་བ_ཐ་མི་དད་པ
སེང | གཟུགས་མི་འགྱུར་བ_ཐ་མི་དད་པ
སེད | གསེད_སྐུལ་ཚིག_འབྲི་ཚུལ
སེམས | སེམས_ད་ལྟ་བ།_ཐ་དད་པ
སེར | གཟུགས་མི་འགྱུར་བ_ཐ་མི་དད་པ
སེལ | བསལ_ད་ལྟ་བ།_ཐ་དད་པ+གཟུགས་མི་འགྱུར་བ_ཐ་མི་དད་པ+སེལ_ད་ལྟ་བ།_ཐ་དད་པ+སེལ_ད་ལྟ་བ།_###
སོགས | གསོག_སྐུལ་ཚིག_ཐ་དད་པ+གསོག_སྐུལ་ཚིག_###
སོང | འགྲོ_སྐུལ་ཚིག_ཐ་མི་དད་པ+སོང_འདས་པ།_ཐ་མི་དད་པ+འགྲོ_འདས་པ།_ཐ་མི་དད་པ+སོང_སྐུལ་ཚིག_ཐ་མི་དད་པ+འགྲོ_འདས་པ།_###
སོངས | བསང_སྐུལ་ཚིག_ཐ་དད་པ
སོད | གསོད_སྐུལ་ཚིག_ཐ་དད་པ+གསོད_སྐུལ་ཚིག_###
སོན | གཟུགས་མི་འགྱུར་བ_ཐ་མི་དད་པ
སོབས | གསོབ_སྐུལ་ཚིག_ཐ་དད་པ+གསོབ_སྐུལ་ཚིག_###
སོམས | སེམས_སྐུལ་ཚིག_ཐ་དད་པ
སོལ | སེལ_སྐུལ་ཚིག_###+སེལ_སྐུལ་ཚིག_ཐ་དད་པ+བསལ_སྐུལ་ཚིག_ཐ་དད་པ
སོས | གསོ_སྐུལཚིག_འབྲི་ཚུལ+བྱ་ཚིག_###+གཟུགས་མི་འགྱུར་བ_ཐ་མི་དད་པ
སྐུག | སྐུག_ད་ལྟ་བ།_ཐ་དད་པ
སྐུགས | སྐུག_སྐུལ་ཚིག_ཐ་དད་པ
སྐུང | སྐུང_ད་ལྟ་བ།_ཐ་དད་པ
སྐུངས | སྐུང_སྐུལ་ཚིག_ཐ་དད་པ
སྐུད | སྐུད_ད་ལྟ་བ།_ཐ་དད་པ
སྐུམ | སྐུམ_ད་ལྟ་བ།_ཐ་དད་པ
སྐུམས | སྐུམ_སྐུལ་ཚིག_ཐ་དད་པ
སྐུར | སྐུར_སྐུལ་ཚིག_###+བསྐུར_ད་ལྟ་བ།_ཐ་དད་པ+སྐུར_ད་ལྟ་བ།_ཐ་དད་པ+སྐུར_སྐུལ་ཚིག_ཐ་དད་པ+སྐུར_ད་ལྟ་བ།_###+བསྐུར_སྐུལ་ཚིག_ཐ་དད་པ
སྐུལ | བསྐུལ_སྐུལ་ཚིག_ཐ་དད་པ+བསྐུལ_ད་ལྟ་བ།_ཐ་དད་པ+སྐུལ_སྐུལ་ཚིག_ཐ་དད་པ+སྐུལ_ད་ལྟ་བ།_ཐ་དད་པ
སྐུས | སྐུད_སྐུལ་ཚིག_ཐ་དད་པ
སྐེམ | སྐེམ_ད་ལྟ་བ།_ཐ་མི་དད་པ+སྐེམ_ད་ལྟ་བ།_ཐ་དད་པ
སྐེམས | སྐེམ_སྐུལཚིག_འབྲི་ཚུལ
སྐོ | སྐོ_ད་ལྟ་བ།_ཐ་དད་པ
སྐོང | སྐོང_ད་ལྟ་བ།_ཐ་དད་པ+སྐོང_ད་ལྟ་བ།_###
སྐོངས | སྐོང_སྐུལ་ཚིག_ཐ་དད་པ+སྐོང_སྐུལ་ཚིག_###
སྐོན | སྐོན_ད་ལྟ་བ།_ཐ་དད་པ+བསྐོན_ད་ལྟ་བ།_ཐ་དད་པ+བསྐོན_སྐུལ་ཚིག_ཐ་དད་པ+སྐོན_སྐུལ་ཚིག_ཐ་དད་པ
སྐོམ | གཟུགས་མི་འགྱུར་བ_ཐ་དད་པ
སྐོམས | སྐེམ_སྐུལ་ཚིག_ཐ་དད་པ
སྐོར | སྐོར_སྐུལ་ཚིག_###+སྐོར_ད་ལྟ་བ།_ཐ་དད་པ+བསྐོར_སྐུལ་ཚིག_ཐ་དད་པ+བསྐོར_ད་ལྟ་བ།_ཐ་དད་པ+སྐོར_སྐུལ་ཚིག_ཐ་དད་པ+སྐོར_ད་ལྟ་བ།_###
སྐོལ | བསྐོལ_སྐུལ་ཚིག_ཐ་དད་པ+བསྐོལ_ད་ལྟ་བ།_ཐ་དད་པ+སྐོལ_ད་ལྟ་བ།_ཐ་དད་པ
སྐོས | སྐོ_སྐུལ་ཚིག_ཐ་དད་པ
སྐྱ | སྐྱ_ད་ལྟ་བ།_ཐ་དད་པ
སྐྱི | སྐྱི_ད་ལྟ་བ།_ཐ་དད་པ
སྐྱིལ | བསྐྱིལ_ད་ལྟ་བ།_ཐ་དད་པ+སྐྱིལ_སྐུལ་ཚིག_###+སྐྱིལ_ད་ལྟ་བ།_ཐ་དད་པ+བསྐྱིལ_སྐུལ་ཚིག_ཐ་དད་པ+སྐྱིལ_སྐུལ་ཚིག_ཐ་དད་པ+སྐྱིལ_ད་ལྟ་བ།_###
སྐྱིས | སྐྱི_སྐུལ་ཚིག_ཐ་དད་པ
སྐྱུག | སྐྱུག_ད་ལྟ་བ།_ཐ་དད་པ
སྐྱུགས | སྐྱུག_སྐུལ་ཚིག_ཐ་དད་པ
སྐྱུང | སྐྱུང_ད་ལྟ་བ།_ཐ་དད་པ
སྐྱུངས | སྐྱུང_སྐུལ་ཚིག_ཐ་དད་པ
སྐྱུད | སྐྱུད_ད་ལྟ་བ།_ཐ་དད་པ+བསྐྱུད_ད་ལྟ་བ།_ཐ་དད་པ
སྐྱུར | སྐྱུར_སྐུལ་ཚིག_ཐ་དད་པ+སྐྱུར_ད་ལྟ་བ།_###+བསྐྱུར_ད་ལྟ་བ།_ཐ་དད་པ+སྐྱུར_སྐུལ་ཚིག_###+སྐྱུར_ད་ལྟ་བ།_ཐ་དད་པ+བསྐྱུར_སྐུལ་ཚིག_ཐ་དད་པ
སྐྱེ | སྐྱེ_མ་འོངས་པ།_ཐ་མི་དད་པ+སྐྱེ_ད་ལྟ་བ།_ཐ་མི་དད་པ
སྐྱེངས | གཟུགས་མི་འགྱུར་བ_ཐ་མི་དད་པ
སྐྱེད | སྐྱེད_སྐུལ་ཚིག_ཐ་དད་པ+བསྐྱེད_སྐུལ་ཚིག_ཐ་དད་པ+སྐྱེད_ད་ལྟ་བ།_ཐ་དད་པ+བསྐྱེད_ད་ལྟ་བ།_ཐ་དད་པ+སྐྱེད_ད་ལྟ་བ།_###+སྐྱེད_སྐུལ་ཚིག_###
སྐྱེལ | སྐྱེལ_ད་ལྟ་བ།_ཐ་དད་པ+བསྐྱལ_ད་ལྟ་བ།_ཐ་དད་པ+སྐྱེལ_ད་ལྟ་བ།_###
སྐྱེས | སྐྱེ_འདས་པ།_ཐ་མི་དད་པ
སྐྱོ | གཟུགས་མི་འགྱུར་བ_ཐ་མི་དད་པ+བྱ་ཚིག_###
སྐྱོག | སྐྱོག_ད་ལྟ་བ།_ཐ་དད་པ+སྐྱོག_ད་ལྟ་བ།_###
སྐྱོགས | སྐྱོག_སྐུལ་ཚིག_ཐ་དད་པ+སྐྱོག_སྐུལ་ཚིག_###
སྐྱོང | བསྐྱངས_ད་ལྟ་བ།_ཐ་དད་པ+བསྐྱང_ད་ལྟ་བ།_ཐ་དད་པ+སྐྱོང_ད་ལྟ་བ།_ཐ་དད་པ+སྐྱོང_ད་ལྟ་བ།_###
སྐྱོངས | སྐྱོང_སྐུལ་ཚིག_###+སྐྱོང_སྐུལ་ཚིག_ཐ་དད་པ+བསྐྱང_སྐུལ་ཚིག_ཐ་དད་པ+བསྐྱངས_སྐུལ་ཚིག_ཐ་དད་པ
སྐྱོད | སྐྱོད_སྐུལ་ཚིག_ཐ་དད་པ+སྐྱོད_སྐུལ་ཚིག_###+སྐྱོད_ད་ལྟ་བ།_###+བསྐྱོད_སྐུལ་ཚིག_ཐ་དད་པ+བསྐྱོད_ད་ལྟ་བ།_ཐ་དད་པ+སྐྱོད_ད་ལྟ་བ།_ཐ་དད་པ
སྐྱོན | བསྐྱོན_སྐུལ་ཚིག_ཐ་དད་པ+སྐྱོན_སྐུལ་ཚིག_ཐ་དད་པ+བསྐྱོན_ད་ལྟ་བ།_ཐ་དད་པ+སྐྱོན_ད་ལྟ་བ།_###+སྐྱོན_ད་ལྟ་བ།_ཐ་དད་པ+སྐྱོན_སྐུལ་ཚིག_###
སྐྱོབ | སྐྱོབ_ད་ལྟ་བ།_ཐ་དད་པ+བསྐྱབས_ད་ལྟ་བ།_ཐ་དད་པ
སྐྱོབས | བསྐྱབས_སྐུལ་ཚིག_ཐ་དད་པ+སྐྱོབ_སྐུལ་ཚིག_ཐ་དད་པ
སྐྱོམ | སྐྱོམ_ད་ལྟ་བ།_###+སྐྱོམ_ད་ལྟ་བ།_ཐ་དད་པ
སྐྱོམས | སྐྱོམ_སྐུལ་ཚིག_ཐ་དད་པ+སྐྱོམ_སྐུལ་ཚིག_###
སྐྱོར | བསྐྱོར_སྐུལ་ཚིག_###+སྐྱོར_ད་ལྟ་བ།_###+སྐྱོར_སྐུལ་ཚིག_ཐ་དད་པ+བསྐྱར_ད་ལྟ་བ།_ཐ་དད་པ+སྐྱོར_སྐུལ་ཚིག_###+བསྐྱོར_ད་ལྟ་བ།_###+སྐྱོར_ད་ལྟ་བ།_ཐ་དད་པ+བསྐྱར_སྐུལ་ཚིག_ཐ་དད་པ+བསྐྱོར_སྐུལ་ཚིག_ཐ་དད་པ+བསྐྱོར_ད་ལྟ་བ།_ཐ་དད་པ
སྐྱོལ | སྐྱེལ_སྐུལ་ཚིག_###+སྐྱེལ_སྐུལ་ཚིག_ཐ་དད་པ+བསྐྱལ_སྐུལ་ཚིག_ཐ་དད་པ
སྐྱོས | སྐྱ_སྐུལ་ཚིག_ཐ་དད་པ
སྐྲག | གཟུགས་མི་འགྱུར་བ_ཐ་མི་དད་པ
སྐྲང | སྐྲང_མ་འོངས་པ།_ཐ་དད་པ+སྐྲང_ད་ལྟ་བ།_ཐ་དད་པ
སྐྲངས | སྐྲང_འདས་པ།_ཐ་དད་པ
སྐྲབ | གཟུགས་མི་འགྱུར་བ_ཐ་དད་པ
སྐྲུ | སྐྲུ_ད་ལྟ་བ།_ཐ་དད་པ+སྐྲུ_ད་ལྟ་བ།_###
སྐྲུན | སྐྲུན_སྐུལ་ཚིག_ཐ་དད་པ+བསྐྲུན_སྐུལ་ཚིག_ཐ་དད་པ+བསྐྲུན_ད་ལྟ་བ།_ཐ་དད་པ+སྐྲུན_ད་ལྟ་བ།_ཐ་དད་པ
སྐྲུས | སྐྲུ_སྐུལ་ཚིག_ཐ་དད་པ+སྐྲུ_སྐུལ་ཚིག_###
སྐྲོག | སྐྲོག_ད་ལྟ་བ།_ཐ་དད་པ+དཀྲོག_འབྲི་ཚུལ+སྐྲོག_ད་ལྟ་བ།_###
སྐྲོགས | སྐྲོག_སྐུལ་ཚིག_###+སྐྲོག_སྐུལ་ཚིག_ཐ་དད་པ
སྐྲོད | བསྐྲད_སྐུལ་ཚིག_ཐ་དད་པ+བསྐྲད_ད་ལྟ་བ།_ཐ་དད་པ+སྐྲོད_སྐུལ་ཚིག_ཐ་དད་པ+སྐྲོད_ད་ལྟ་བ།_ཐ་དད་པ
སྒབ | སྒབ_ད་ལྟ་བ།_ཐ་དད་པ
སྒར | སྒར_ད་ལྟ་བ།_ཐ་དད་པ+བསྒར_ད་ལྟ་བ།_###
སྒུག | སྒུགས_ད་ལྟ་བ།_ཐ་དད་པ+སྒུག_ད་ལྟ་བ།_ཐ་དད་པ
སྒུགས | སྒུགས_སྐུལ་ཚིག_ཐ་དད་པ+སྒུག_སྐུལ་ཚིག_ཐ་དད་པ
སྒུར | བསྒུར_ད་ལྟ་བ།_ཐ་དད་པ+བསྒུར_སྐུལ་ཚིག_ཐ་དད་པ+སྒུར_སྐུལ་ཚིག_ཐ་མི་དད་པ+སྒུར_ད་ལྟ་བ།_ཐ་མི་དད་པ
སྒུལ | སྒུལ_ད་ལྟ་བ།_ཐ་དད་པ+བསྒུལ_ད་ལྟ་བ།_ཐ་དད་པ+བསྒུལ_སྐུལ་ཚིག_ཐ་དད་པ+སྒུལ_སྐུལ་ཚིག_ཐ་དད་པ
སྒོ | སྒོ_ད་ལྟ་བ།_ཐ་དད་པ+བསྒོས_ད་ལྟ་བ།_ཐ་དད་པ+སྒོ_ད་ལྟ་བ།_###
སྒོག | སྒོག_ད་ལྟ་བ།_###+སྒོག_ད་ལྟ་བ།_ཐ་དད་པ
སྒོགས | སྒོག_སྐུལ་ཚིག_###+སྒོག_སྐུལ་ཚིག_ཐ་དད་པ
སྒོང | སྒོང_ད་ལྟ་བ།_ཐ་དད་པ
སྒོངས | སྒོང_སྐུལ་ཚིག_ཐ་དད་པ
སྒོབས | སྒབ_སྐུལ་ཚིག_ཐ་དད་པ
སྒོམ | སྒོམ_ད་ལྟ་བ།_ཐ་དད་པ
སྒོམས | སྒོམ_སྐུལ་ཚིག_ཐ་དད་པ
སྒོར | སྒར_སྐུལ་ཚིག_ཐ་དད་པ+བསྒར_སྐུལ་ཚིག_ཐ་དད་པ+སྒོར_སྐུལ་ཚིག_ཐ་དད་པ+གཟུགས་མི་འགྱུར་བ_###+སྒོར_ད་ལྟ་བ།_ཐ་དད་པ+བསྒར_ད་ལྟ་བ།_ཐ་དད་པ+བསྒར_སྐུལ་ཚིག_###
སྒོས | སྒོ_སྐུལ་ཚིག_ཐ་དད་པ+བསྒོས_སྐུལ་ཚིག_ཐ་དད་པ+སྒོ_སྐུལ་ཚིག_###
སྒྱང | སྒྱང_ད་ལྟ་བ།_ཐ་དད་པ
སྒྱིང | སྒྱིང_ད་ལྟ་བ།_###+སྒྱིང_ད་ལྟ་བ།_ཐ་དད་པ
སྒྱིངས | སྒྱིང_སྐུལ་ཚིག_###+སྒྱིང_སྐུལ་ཚིག_ཐ་དད་པ
སྒྱུར | སྒྱུར_ད་ལྟ་བ།_###+བསྒྱུར_སྐུལ་ཚིག_ཐ་དད་པ+སྒྱུར_སྐུལ་ཚིག_ཐ་དད་པ+སྒྱུར_ད་ལྟ་བ།_ཐ་དད་པ+བསྒྱུར_ད་ལྟ་བ།_ཐ་དད་པ+སྒྱུར_སྐུལ་ཚིག_###
སྒྱེལ | སྒྱེལ_ད་ལྟ་བ།_ཐ་དད་པ+བསྒྱེལ_ད་ལྟ་བ།_ཐ་དད་པ+སྒྱེལ_སྐུལ་ཚིག_ཐ་དད་པ+བསྒྱེལ_སྐུལ་ཚིག_ཐ་དད་པ
སྒྱོངས | སྒྱང_སྐུལ་ཚིག_ཐ་དད་པ
སྒྲང | སྒྲང_ད་ལྟ་བ།_ཐ་དད་པ
སྒྲིག | སྒྲིག_ད་ལྟ་བ།_ཐ་དད་པ
སྒྲིགས | སྒྲིག_སྐུལ་ཚིག_ཐ་དད་པ
སྒྲིན | བསྒྲིན_ད་ལྟ་བ།_ཐ་དད་པ+བསྒྲིན_སྐུལ་ཚིག_ཐ་དད་པ+སྒྲིན_ད་ལྟ་བ།_ཐ་དད་པ+སྒྲིན_སྐུལ་ཚིག_ཐ་དད་པ
སྒྲིབ | སྒྲིབ_ད་ལྟ་བ།_ཐ་དད་པ
སྒྲིབས | སྒྲིབ_སྐུལ་ཚིག_ཐ་དད་པ
སྒྲིམ | སྒྲིམ_ད་ལྟ་བ།_ཐ་དད་པ
སྒྲིམས | སྒྲིམ_སྐུལ་ཚིག_ཐ་དད་པ
སྒྲིལ | སྒྲིལ_སྐུལ་ཚིག_ཐ་དད་པ+སྒྲིལ_ད་ལྟ་བ།_ཐ་དད་པ+སྒྲིལ_སྐུལ་ཚིག_###+བསྒྲིལ_སྐུལ་ཚིག_ཐ་དད་པ+སྒྲིལ_ད་ལྟ་བ།_###+བསྒྲིལ_ད་ལྟ་བ།_ཐ་དད་པ
སྒྲུག | སྒྲུག_ད་ལྟ་བ།_###+སྒྲུག_ད་ལྟ་བ།_ཐ་དད་པ
སྒྲུགས | སྒྲུག_སྐུལ་ཚིག_###+སྒྲུག_སྐུལ་ཚིག_ཐ་དད་པ
སྒྲུང | སྒྲུང_ད་ལྟ་བ།_ཐ་དད་པ+སྒྲུངས_ད་ལྟ་བ།_ཐ་དད་པ
སྒྲུངས | སྒྲུང_སྐུལ་ཚིག_ཐ་དད་པ+སྒྲུངས_སྐུལ་ཚིག_ཐ་དད་པ
སྒྲུན | སྒྲུན_སྐུལ་ཚིག_ཐ་དད་པ+བསྒྲུན_སྐུལ་ཚིག_ཐ་དད་པ+བསྒྲུན_ད་ལྟ་བ།_ཐ་དད་པ+སྒྲུན_ད་ལྟ་བ།_ཐ་དད་པ
སྒྲུབ | སྒྲུབ_ད་ལྟ་བ།_###+སྒྲུབ_ད་ལྟ་བ།_ཐ་དད་པ
སྒྲུབས | སྒྲུབ_སྐུལ་ཚིག_###+སྒྲུབ_སྐུལ་ཚིག_ཐ་དད་པ
སྒྲེ | སྒྲེ_ད་ལྟ་བ།_ཐ་དད་པ+སྒྲེ_ད་ལྟ་བ།_###+བསྒྲེས_ད་ལྟ་བ།_ཐ་དད་པ
སྒྲེང | སྒྲེང_ད་ལྟ་བ།_ཐ་དད་པ
སྒྲེངས | སྒྲེང_སྐུལ་ཚིག_ཐ་དད་པ
སྒྲེས | སྒྲེ_སྐུལ་ཚིག_###+བསྒྲེས_སྐུལ་ཚིག_ཐ་དད་པ+སྒྲེ_སྐུལ་ཚིག_ཐ་དད་པ
སྒྲོ | སྒྲོ_ད་ལྟ་བ།_ཐ་དད་པ
སྒྲོག | སྒྲོག_ད་ལྟ་བ།_###+སྒྲོག_ད་ལྟ་བ།_ཐ་དད་པ
སྒྲོགས | སྒྲོག_སྐུལ་ཚིག_ཐ་དད་པ+སྒྲོག_སྐུལ་ཚིག_###
སྒྲོངས | སྒྲང_སྐུལ་ཚིག_ཐ་དད་པ
སྒྲོད | སྒྲོད_ད་ལྟ་བ།_ཐ་དད་པ+སྒྲོད_སྐུལ་ཚིག_ཐ་དད་པ
སྒྲོན | བསྒྲོན_སྐུལ་ཚིག_ཐ་དད་པ+བསྒྲོན_ད་ལྟ་བ།_ཐ་དད་པ+སྒྲོན_སྐུལ་ཚིག_###+སྒྲོན_ད་ལྟ་བ།_ཐ་དད་པ+སྒྲོན_སྐུལ་ཚིག_ཐ་དད་པ+སྒྲོན_ད་ལྟ་བ།_###
སྒྲོལ | བསྒྲལ_སྐུལ་ཚིག_ཐ་དད་པ+སྒྲོལ_སྐུལ་ཚིག_###+བསྒྲལ_ད་ལྟ་བ།_ཐ་དད་པ+སྒྲོལ_སྐུལ་ཚིག_ཐ་དད་པ+སྒྲོལ_ད་ལྟ་བ།_###+སྒྲོལ_ད་ལྟ་བ།_ཐ་དད་པ
སྒྲོས | སྒྲོ_སྐུལ་ཚིག_ཐ་དད་པ
སྔག | བསྔགས_ད་ལྟ་བ_འབྲི་ཚུལ
སྔངས | སྔངས_ད་ལྟ་བ།_ཐ་མི་དད་པ
སྔབ | གཟུགས་མི་འགྱུར་བ_ཐ་མི་དད་པ
སྔམ | གཟུགས་མི་འགྱུར་བ_ཐ་མི་དད་པ
སྔོ | སྔོ_ད་ལྟ་བ།_ཐ་དད་པ+བསྔོས_ད་ལྟ་བ།_ཐ་དད་པ
སྔོག | སྔོག_ད་ལྟ་བ།_ཐ་དད་པ+སྔོག_ད་ལྟ་བ།_###
སྔོགས | སྔོག_སྐུལ་ཚིག_###+སྔོག_སྐུལ་ཚིག_ཐ་དད་པ
སྔོངས | སྔངས_སྐུལ་ཚིག_འབྲི་ཚུལ
སྔོས | སྔོ_སྐུལ་ཚིག_ཐ་དད་པ+བསྔོས_སྐུལ་ཚིག_ཐ་དད་པ
སྙ | སྙ_མ་འོངས་པ།_###+སྙ_ད་ལྟ་བ།_###+སྙ_མ་འོངས་པ།_ཐ་མི་དད་པ+སྙ_ད་ལྟ་བ།_ཐ་མི་དད་པ
སྙད | སྙད_ད་ལྟ་བ།_ཐ་དད་པ
སྙམ | གཟུགས་མི་འགྱུར་བ_ཐ་དད་པ
སྙལ | བསྙལ_ད་ལྟ་བ།_ཐ་དད་པ+སྙལ_ད་ལྟ་བ།_ཐ་དད་པ+སྙལ_ད་ལྟ་བ།_###
སྙས | སྙ_འདས་པ།_###+སྙ_འདས་པ།_ཐ་མི་དད་པ
སྙིག | སྙིག_ད་ལྟ་བ།_###+སྙིག_མ་འོངས་པ།_###+སྙིག_ད་ལྟ་བ།_ཐ་དད་པ+སྙིག_ད་ལྟ་བ།_ཐ་མི་དད་པ+སྙིག_མ་འོངས་པ།_ཐ་མི་དད་པ
སྙིགས | སྙིག_སྐུལ་ཚིག_ཐ་དད་པ+གཟུགས་མི་འགྱུར་བ_ཐ་མི་དད་པ+སྙིག_འདས་པ།_ཐ་མི་དད་པ+སྙིག_འདས་པ།_###
སྙིལ | སྙིལ_སྐུལ་ཚིག_ཐ་དད་པ+སྙིལ_ད་ལྟ་བ།_###+བསྙིལ_སྐུལ་ཚིག_ཐ་དད་པ+སྙིལ_སྐུལ་ཚིག_###+བསྙིལ_ད་ལྟ་བ།_ཐ་དད་པ+སྙིལ_ད་ལྟ་བ།_ཐ་དད་པ
སྙུག | སྙུག_ད་ལྟ་བ།_ཐ་དད་པ
སྙུགས | སྙུག_སྐུལ་ཚིག_ཐ་དད་པ
སྙུང | སྙུང_ད་ལྟ་བ།_ཐ་དད་པ+སྙུང_ད་ལྟ་བ།_ཐ་མི་དད་པ
སྙུངས | སྙུང_སྐུལ་ཚིག_ཐ་དད་པ
སྙུན | བསྙུན_ད་ལྟ་བ།_ཐ་དད་པ+སྙུན_ད་ལྟ་བ།_ཐ་མི་དད་པ
སྙུལ | སྙུལ_སྐུལ་ཚིག_ཐ་དད་པ+བསྙུལ_སྐུལ་ཚིག_ཐ་དད་པ+བསྙུལ_ད་ལྟ་བ།_ཐ་དད་པ+སྙུལ_ད་ལྟ་བ།_ཐ་དད་པ
སྙེ | སྙེ_ད་ལྟ་བ།_ཐ་དད་པ
སྙེག | སྙེག_ད་ལྟ་བ།_###+སྙེག_ད་ལྟ་བ།_ཐ་དད་པ
སྙེགས | སྙེག_སྐུལཚིག_འབྲི་ཚུལ
སྙེང | སྙེང_ད་ལྟ་བ།_ཐ་དད་པ+སྙེང_ད་ལྟ་བ།_ཐ་མི་དད་པ+སྙེང_ད་ལྟ་བ།_###
སྙེངས | སྙེང_སྐུལ་ཚིག_ཐ་དད་པ
སྙེན | སྙེན_སྐུལ་ཚིག_ཐ་དད་པ+བསྙེན_ད་ལྟ་བ།_ཐ་དད་པ+བསྙེན_སྐུལ་ཚིག_ཐ་དད་པ+སྙེན_ད་ལྟ་བ།_ཐ་དད་པ
སྙེམ | སྙེམ_ད་ལྟ་བ།_ཐ་དད་པ
སྙེམས | སྙེམ_སྐུལ་ཚིག_ཐ་དད་པ
སྙེར | སྙེར_སྐུལ་ཚིག_ཐ་དད་པ+བསྙེར_སྐུལ་ཚིག_ཐ་དད་པ+བསྙེར_ད་ལྟ་བ།_ཐ་དད་པ+སྙེར_ད་ལྟ་བ།_ཐ་དད་པ
སྙེལ | སྙེལ_ད་ལྟ་བ།_ཐ་དད་པ+བསྙེལ_ད་ལྟ་བ།_ཐ་དད་པ
སྙེས | སྙེ_སྐུ་ཚིག_ཐ་དད་པ
སྙོག | སྙོག_ད་ལྟ་བ།_ཐ་དད་པ+སྙོག_ད་ལྟ་བ།_###
སྙོགས | སྙེག_སྐུལ་ཚིག_###+སྙེག_སྐུལ་ཚིག_ཐ་དད་པ+སྙོག_སྐུལ་ཚིག_###+སྙོག_སྐུལ་ཚིག_ཐ་དད་པ
སྙོད | སྙད_སྐུལ་ཚིག_ཐ་དད་པ+སྙོད_སྐུལ་ཚིག_###+སྙོད_ད་ལྟ་བ།_###+སྙོད_ད་ལྟ་བ།_ཐ་དད་པ+བསྙོད_ད་ལྟ་བ།_ཐ་དད་པ+བསྙོད_སྐུལ་ཚིག_ཐ་དད་པ+སྙོད_སྐུལ་ཚིག_ཐ་དད་པ+བསྙད_ད་ལྟ་བ།_ཐ་དད་པ+བསྙད_སྐུལ་ཚིག_ཐ་དད་པ
སྙོན | བསྙོན_སྐུལ་ཚིག_ཐ་དད་པ+སྙོན_ད་ལྟ་བ།_ཐ་དད་པ+བསྙོན_ད་ལྟ་བ།_ཐ་དད་པ+སྙོན_སྐུལ་ཚིག_ཐ་དད་པ
སྙོབ | སྙོབ_ད་ལྟ་བ།_ཐ་དད་པ
སྙོབས | སྙོབ_སྐུལ་ཚིག_ཐ་དད་པ
སྙོམ | བྱ་ཚིག_ཐ་མི་དད་པ+སྙོམ_ད་ལྟ་བ།_ཐ་དད་པ
སྙོམས | སྙོམ_སྐུལ་ཚིག_ཐ་དད་པ
སྙོར | བསྙོར_སྐུལ་ཚིག_ཐ་དད་པ+སྙོར_སྐུལ་ཚིག_ཐ་དད་པ+སྙོར_ད་ལྟ་བ།_ཐ་དད་པ+བསྙོར_ད་ལྟ་བ།_ཐ་དད་པ
སྙོལ | བསྙལ_སྐུལ་ཚིག_ཐ་དད་པ+སྙལ_སྐུལ་ཚིག_###+སྙལ_སྐུལ་ཚིག_ཐ་དད་པ
སྟང | སྟང_ད་ལྟ་བ།_ཐ་དད་པ
སྟར | སྟར_ད་ལྟ་བ།_###+སྟར_ད་ལྟ་བ།_ཐ་དད་པ+བསྟར_ད་ལྟ་བ།_ཐ་དད་པ
སྟི | སྟི_ད་ལྟ་བ།_ཐ་མི་དད་པ+སྟིས_ད་ལྟ་བ།_ཐ་མི་དད་པ
སྟིང | སྟིང_ད་ལྟ་བ།_ཐ་དད་པ
སྟིངས | སྟིང_སྐུལ་ཚིག_ཐ་དད་པ
སྟིམ | སྟིམ_ད་ལྟ་བ།_ཐ་དད་པ+སྟིམ_ད་ལྟ་བ།_###
སྟིམས | སྟིམ_སྐུལ་ཚིག_ཐ་དད་པ+སྟིམ_སྐུལ་ཚིག_###
སྟིས | སྟིས_སྐུལ་ཚིག_ཐ་མི་དད་པ+སྟི_སྐུལ་ཚིག_ཐ་མི་དད་པ
སྟུང | སྟུང_ད་ལྟ་བ།_ཐ་མི་དད་པ+སྟུང_ད་ལྟ་བ།_###
སྟུངས | སྟུང_སྐུལ་ཚིག_###+སྟུང_སྐུལ་ཚིག_ཐ་མི་དད་པ
སྟུད | བསྟུད_ད་ལྟ་བ།_ཐ་དད་པ+སྟུད_ད་ལྟ་བ།_ཐ་དད་པ+སྟུད_སྐུལ་ཚིག_ཐ་དད་པ+བསྟུད_སྐུལ་ཚིག_ཐ་དད་པ
སྟུན | བསྟུན_ད་ལྟ་བ།_ཐ་དད་པ+སྟུན_ད་ལྟ་བ།_ཐ་དད་པ+བསྟུན_སྐུལ་ཚིག_ཐ་དད་པ+སྟུན_སྐུལ་ཚིག_ཐ་དད་པ
སྟེག | གཟུགས་མི་འགྱུར་བ_ཐ་མི་དད་པ
སྟེན | སྟེན_སྐུལ་ཚིག_###+སྟེན_ད་ལྟ་བ།_###+སྟེན_སྐུལ་ཚིག_ཐ་དད་པ+སྟེན_ད་ལྟ་བ།_ཐ་དད་པ+བསྟེན_སྐུལ་ཚིག_ཐ་དད་པ+བསྟེན_ད་ལྟ་བ།_ཐ་དད་པ
སྟེར | གཟུགས་མི་འགྱུར་བ_ཐ་དད་པ
སྟོང | སྟོང_མ་འོངས་པ།_ཐ་མི་དད་པ+སྟོང_ད་ལྟ་བ།_ཐ་མི་དད་པ
སྟོངས | སྟོང_འདས་པ།_ཐ་མི་དད་པ+སྟང_སྐུལ་ཚིག_ཐ་དད་པ
སྟོད | སྟོད_སྐུལ་ཚིག_ཐ་དད་པ+བསྟད_སྐུལ་ཚིག_ཐ་དད་པ+བསྟད_ད་ལྟ་བ།_ཐ་དད་པ+སྟོད_ད་ལྟ་བ།_###+སྟོད_ད་ལྟ་བ།_ཐ་དད་པ
སྟོན | སྟོན_ད་ལྟ་བ།_ཐ་དད་པ+སྟོན_སྐུལ་ཚིག_ཐ་དད་པ
སྟོབ | སྟོབ_ད་ལྟ་བ།_ཐ་དད་པ
སྟོབས | སྟོབ_སྐུལ་ཚིག_ཐ་དད་པ
སྟོར | བསྟར_སྐུལ་ཚིག_ཐ་དད་པ+སྟོར_ད་ལྟ་བ།_###+བསྟར_ད་ལྟ་བ།_###+བསྟར_སྐུལ་ཚིག_###+གཟུགས་མི་འགྱུར་བ_ཐ་མི་དད་པ+སྟོར_སྐུལ་ཚིག_ཐ་དད་པ+སྟར_སྐུལ་ཚིག_ཐ་དད་པ+སྟོར_སྐུལ་ཚིག_###+སྟོར_ད་ལྟ་བ།_ཐ་དད་པ+སྟར_སྐུལ་ཚིག_###
སྡང | གཟུགས་མི་འགྱུར་བ_ཐ་མི་དད་པ+བྱ་ཚིག_###
སྡིག | སྡིག_ད་ལྟ་བ།_###+སྡིག_ད་ལྟ་བ།_ཐ་དད་པ
སྡིགས | སྡིག_སྐུལ་ཚིག_###+སྡིག_སྐུལ་ཚིག_ཐ་དད་པ
སྡུག | གཟུགས་མི་འགྱུར་བ_ཐ་མི་དད་པ
སྡུད | སྡུད_ད་ལྟ་བ།_###+སྡུད_ད་ལྟ་བ།_ཐ་དད་པ
སྡུམ | སྡུམ_ད་ལྟ་བ།_ཐ་དད་པ
སྡུམས | སྡུམ_སྐུལ་ཚིག_ཐ་དད་པ
སྡུར | སྡུར_ད་ལྟ་བ།_ཐ་དད་པ+སྡུར_སྐུལ་ཚིག_ཐ་དད་པ+བསྡུར_ད་ལྟ་བ།_ཐ་དད་པ+བསྡུར_སྐུལ་ཚིག_ཐ་དད་པ
སྡུས | སྡུད_སྐུལ་ཚིག_###+སྡུད_སྐུལ་ཚིག_ཐ་དད་པ
སྡེབ | སྡེབ_ད་ལྟ་བ།_ཐ་དད་པ
སྡེབས | སྡེབ_སྐུལ་ཚིག_ཐ་དད་པ
སྡོ | སྡོ_ད་ལྟ་བ།_ཐ་དད་པ+སྡོ_ད་ལྟ་བ།_###
སྡོག | སྡོག_ད་ལྟ་བ།_###+སྡོག_ད་ལྟ་བ།_ཐ་དད་པ
སྡོགས | སྡོག_སྐུལ་ཚིག_###+སྡོག_སྐུལ་ཚིག_ཐ་དད་པ
སྡོང | སྡོང_ད་ལྟ་བ།_ཐ་མི་དད་པ
སྡོངས | སྡོང_སྐུལ་ཚིག_ཐ་མི་དད་པ
སྡོད | བསྡད_ད་ལྟ་བ།_ཐ་མི་དད་པ+སྡོད_སྐུལ་ཚིག_ཐ་མི་དད་པ+བསྡད_སྐུལ་ཚིག_ཐ་མི་དད་པ+སྡོད_སྐུལ་ཚིག_###+སྡོད_ད་ལྟ་བ།_ཐ་མི་དད་པ+སྡོད_ད་ལྟ་བ།_###
སྡོམ | སྡོམ_ད་ལྟ་བ།_ཐ་དད་པ+སྡོམ_ད་ལྟ་བ།_###
སྡོམས | སྡོམ_སྐུལ་ཚིག_ཐ་དད་པ+སྡོམ_སྐུལ་ཚིག_###
སྡོས | སྡོ_སྐུལ་ཚིག_###+སྡོ_སྐུལ་ཚིག_ཐ་དད་པ
སྣང | གཟུགས་མི་འགྱུར་བ_ཐ་མི་དད་པ
སྣད | བསྣད_ད་ལྟ་བ།_ཐ་དད་པ+སྣད_ད་ལྟ་བ།_ཐ་དད་པ
སྣར | བསྣར_ད་ལྟ་བ།_ཐ་དད་པ+སྣར_ད་ལྟ་བ།_###+སྣར_ད་ལྟ་བ།_ཐ་དད་པ
སྣུད | བསྣུད_ད་ལྟ་བ།_ཐ་དད་པ+སྣུད_ད་ལྟ་བ།_ཐ་དད་པ+བསྣུད_སྐུལ་ཚིག_ཐ་དད་པ+སྣུད_སྐུལ་ཚིག_ཐ་དད་པ
སྣུན | སྣུན_སྐུལ་ཚིག_ཐ་དད་པ+སྣུན_ད་ལྟ་བ།_ཐ་དད་པ+སྣུན_ད་ལྟ་བ།_###+བསྣུན_ད་ལྟ་བ།_ཐ་དད་པ+བསྣུན_སྐུལ་ཚིག_ཐ་དད་པ+སྣུན_སྐུལ་ཚིག_###
སྣུབ | སྣུབ_ད་ལྟ་བ།_ཐ་དད་པ
སྣུབས | སྣུབ_སྐུལ་ཚིག_ཐ་དད་པ
སྣུར | སྣུར_ད་ལྟ་བ།_ཐ་མི་དད་པ+སྣུར_སྐུལ་ཚིག_###+སྣུར_ད་ལྟ་བ།_###+སྣུར_ད་ལྟ་བ།_ཐ་དད་པ+སྣུར_སྐུལ་ཚིག_ཐ་དད་པ+བསྣུར_ད་ལྟ་བ།_ཐ་དད་པ+བསྣུར_སྐུལ་ཚིག_ཐ་དད་པ
སྣེམ | སྣེམ_ད་ལྟ་བ།_###+སྣེམ_ད་ལྟ་བ།_ཐ་དད་པ
སྣེམས | སྣེམ_སྐུལ་ཚིག_ཐ་དད་པ+སྣེམ_སྐུལ་ཚིག_###
སྣོ | སྣོ_ད་ལྟ་བ།_ཐ་དད་པ
སྣོག | སྣོག_ད་ལྟ་བ།_ཐ་དད་པ+སྣོགས_ད་ལྟ་བ།_ཐ་དད་པ+སྣོག_ད་ལྟ་བ།_###
སྣོགས | སྣོགས_སྐུལ་ཚིག_ཐ་དད་པ+སྣོག_སྐུལ་ཚིག_ཐ་དད་པ+སྣོག_སྐུལ་ཚིག_###
སྣོད | བསྣད_སྐུལ་ཚིག_ཐ་དད་པ+སྣད_སྐུལ་ཚིག_ཐ་དད་པ
སྣོན | བསྣན_སྐུལ་ཚིག_ཐ་དད་པ+བསྣན_ད་ལྟ་བ།_ཐ་དད་པ+སྣོན_སྐུལ་ཚིག_ཐ་དད་པ+སྣོན_སྐུལ་ཚིག_###+སྣོན_ད་ལྟ་བ།_ཐ་དད་པ+སྣོན_ད་ལྟ་བ།_###
སྣོམ | སྣོམ_ད་ལྟ་བ།_###+སྣོམ_ད་ལྟ་བ།_ཐ་དད་པ
སྣོམས | སྣོམ_སྐུལ་ཚིག_ཐ་དད་པ+སྣོམ_སྐུལ་ཚིག_###+སྣོམས_སྐུལ་ཚིག_ཐ་དད་པ
སྣོར | སྣར_སྐུལ་ཚིག_ཐ་དད་པ+བསྣོར_ད་ལྟ་བ།_ཐ་དད་པ+སྣར_སྐུལ་ཚིག_###+སྣོར_ད་ལྟ་བ།_ཐ་དད་པ+བསྣོར_སྐུལ་ཚིག_ཐ་དད་པ+སྣོར_སྐུལ་ཚིག_ཐ་དད་པ+བསྣར_སྐུལ་ཚིག_ཐ་དད་པ
སྣོལ | བསྣོལ_སྐུལ་ཚིག_ཐ་དད་པ+སྣོམས_ད་ལྟ་བ།_ཐ་དད་པ+སྣོལ_ད་ལྟ་བ།_ཐ་དད་པ+བསྣོལ_ད་ལྟ་བ།_ཐ་དད་པ+སྣོལ_སྐུལ་ཚིག_ཐ་དད་པ
སྣོས | སྣོ_སྐུལ་ཚིག_ཐ་དད་པ
སྤ | གཟུགས་མི་འགྱུར་བ_ཐ་དད་པ
སྤག | སྤག_མ་འོངས་པ།_ཐ་མི་དད་པ+སྤག_མ་འོངས་པ།_###+སྤག_ད་ལྟ་བ།_ཐ་མི་དད་པ+སྤག_ད་ལྟ་བ།_###+སྤོག_མ་འོངས་པ།_ཐ་དད་པ
སྤགས | སྤོག_འདས་པ།_ཐ་དད་པ+གཟུགས་མི་འགྱུར་བ_ཐ་མི་དད་པ+སྤག_འདས་པ།_###+སྤག_འདས་པ།_ཐ་མི་དད་པ
སྤང | སྤོང_མ་འོངས་པ།_ཐ་དད་པ
སྤངས | སྤོང_འདས་པ།_ཐ་དད་པ
སྤར | སྤོར_འདས་པ།_ཐ་དད་པ+སྤོར_མ་འོངས་པ།_###+སྤར_མ་འོངས་པ།_ཐ་དད་པ+སྤོར_འདས་པ།_###+སྤོར_མ་འོངས་པ།_ཐ་དད་པ+སྤར_འདས་པ།_ཐ་དད་པ
སྤུང | སྤུངས_ད་ལྟ་བ།_ཐ་མི་དད་པ+སྤུང_མ་འོངས་པ།_ཐ་དད་པ+སྤུངས_མ་འོངས་པ།_ཐ་མི་དད་པ+སྤུང_ད་ལྟ་བ།_ཐ་དད་པ
སྤུངས | སྤུང_འདས་པ།_ཐ་དད་པ+སྤུང_སྐུལ་ཚིག_ཐ་དད་པ+སྤུངས_འདས་པ།_ཐ་མི་དད་པ+སྤུངས_སྐུལ་ཚིག_ཐ་མི་དད་པ
སྤུད | གཟུགས་མི་འགྱུར་བ_ཐ་དད་པ
སྤུར | གཟུགས་མི་འགྱུར་བ_ཐ་དད་པ
སྤེལ | བྱ་ཚིག_###+གཟུགས་མི་འགྱུར་བ_ཐ་དད་པ
སྤོ | སྤོ_ད་ལྟ་བ།_ཐ་དད་པ+སྤོས_ད་ལྟ་བ།_ཐ་དད་པ+སྤོ_མ་འོངས་པ།_ཐ་དད་པ+སྤོ_མ་འོངས་པ།_###+སྤོ_ད་ལྟ་བ།_###+སྤོས_མ་འོངས་པ།_ཐ་དད་པ
སྤོག | སྤོག_ད་ལྟ་བ།_ཐ་དད་པ
སྤོགས | སྤོག_སྐུལ་ཚིག_ཐ་དད་པ
སྤོང | སྤོང_ད་ལྟ་བ།_ཐ་དད་པ
སྤོངས | སྤོང_སྐུལ་ཚིག_ཐ་དད་པ
སྤོར | སྤོར_སྐུལ་ཚིག_###+སྤོར_ད་ལྟ་བ།_ཐ་དད་པ+སྤར_ད་ལྟ་བ།_ཐ་དད་པ+སྤར_སྐུལ་ཚིག_ཐ་དད་པ+སྤོར_ད་ལྟ་བ།_###+སྤོར_སྐུལ་ཚིག_ཐ་དད་པ
སྤོས | སྤོས_འདས་པ།_ཐ་དད་པ+སྤོ_སྐུལ་ཚིག_ཐ་དད་པ+སྤོ_འདས་པ།_ཐ་དད་པ+སྤོ_སྐུལ་ཚིག_###+སྤོས_སྐུལ་ཚིག_ཐ་དད་པ+སྤོ_འདས་པ།_###
སྤྱང | སྤྱང_མ་འོངས་པ།_ཐ་དད་པ+སྤྱང_ད་ལྟ་བ།_ཐ་དད་པ
སྤྱངས | སྤྱང_འདས་པ།_ཐ་དད་པ
སྤྱད | སྤྱོད_འདས་པ།_ཐ་དད་པ+སྤྱོད_འདས་པ།_###+སྤྱད_འདས་པ།_ཐ་དད་པ+སྤྱོད_མ་འོངས་པ།_###+སྤྱོད_མ་འོངས་པ།_ཐ་དད་པ+སྤྱད_མ་འོངས་པ།_ཐ་དད་པ
སྤྱིང | སྤྱིང_ད་ལྟ་བ།_ཐ་དད་པ+སྤྱིངས_མ་འོངས་པ།_ཐ་དད་པ+སྤྱིང_མ་འོངས་པ།_ཐ་དད་པ+སྤྱིངས_ད་ལྟ་བ།_ཐ་དད་པ
སྤྱིངས | སྤྱིངས_སྐུལ་ཚིག_ཐ་དད་པ+སྤྱིང_སྐུལ་ཚིག_ཐ་དད་པ+སྤྱིངས_འདས་པ།_ཐ་དད་པ+སྤྱིང_འདས་པ།_ཐ་དད་པ
སྤྱིལ | གཟུགས་མི་འགྱུར་བ_ཐ་དད་པ
སྤྱུག | སྤྱུག_ད་ལྟ་བ།_ཐ་དད་པ+སྤྱུགས_མ་འོངས་པ།_ཐ་དད་པ+སྤྱུག_མ་འོངས་པ།_ཐ་དད་པ+སྤྱུགས_ད་ལྟ་བ།_ཐ་དད་པ
སྤྱུགས | སྤྱུག_སྐུལ་ཚིག_ཐ་དད་པ+སྤྱུགས_སྐུལ་ཚིག_ཐ་དད་པ+སྤྱུག_འདས་པ།_ཐ་དད་པ+སྤྱུགས_འདས་པ།_ཐ་དད་པ
སྤྱོ | སྤྱོ_མ་འོངས་པ།_ཐ་དད་པ+སྤྱོས_ད་ལྟ་བ།_ཐ་དད་པ+སྤྱོ_ད་ལྟ་བ།_ཐ་དད་པ+སྤྱོས_མ་འོངས་པ།_ཐ་དད་པ
སྤྱོང | སྤྱང_སྐུལ་ཚིག_ཐ་དད་པ
སྤྱོད | སྤྱོད_སྐུལ་ཚིག_###+སྤྱད_སྐུལ་ཚིག_ཐ་དད་པ+སྤྱོད_ད་ལྟ་བ།_ཐ་དད་པ+སྤྱོད_ད་ལྟ་བ།_###+སྤྱད_ད་ལྟ་བ།_ཐ་དད་པ+སྤྱོད_སྐུལ་ཚིག_ཐ་དད་པ
སྤྱོན | གཟུགས་མི་འགྱུར་བ_ཐ་མི་དད་པ
སྤྱོམ | སྤྱོམས_ད་ལྟ་བ།_ཐ་དད་པ+སྤྱོམ_མ་འོངས་པ།_ཐ་དད་པ+སྤྱོམས_མ་འོངས་པ།_ཐ་དད་པ+སྤྱོམ_ད་ལྟ་བ།_ཐ་དད་པ
སྤྱོམས | སྤྱོམས_སྐུལ་ཚིག_ཐ་དད་པ+སྤྱོམ_སྐུལ་ཚིག_ཐ་དད་པ+སྤྱོམ_འདས་པ།_ཐ་དད་པ+སྤྱོམས_འདས་པ།_ཐ་དད་པ
སྤྱོས | སྤྱོས_སྐུལ་ཚིག_ཐ་དད་པ+སྤྱོས_འདས་པ།_ཐ་དད་པ+སྤྱོ_སྐུལ་ཚིག_ཐ་དད་པ+སྤྱོ_འདས་པ།_ཐ་དད་པ
སྤྲ | སྤྲ_མ་འོངས་པ།_ཐ་དད་པ+སྤྲ_ད་ལྟ་བ།_ཐ་དད་པ+སྤྲས_མ་འོངས་པ།_ཐ་དད་པ+སྤྲས_ད་ལྟ་བ།_ཐ་དད་པ
སྤྲང | གཟུགས་མི་འགྱུར་བ_ཐ་མི་དད་པ
སྤྲད | སྤྲོད_མ་འོངས་པ།_ཐ་དད་པ+སྤྲོད_འདས་པ།_###+སྤྲོད_མ་འོངས་པ།_###+སྤྲད_མ་འོངས་པ།_ཐ་དད་པ+སྤྲད_འདས་པ།_ཐ་དད་པ+སྤྲོད_འདས་པ།_ཐ་དད་པ
སྤྲས | སྤྲ_སྐུལ་ཚིག_ཐ་དད་པ+སྤྲ_འདས་པ།_ཐ་དད་པ+སྤྲས_སྐུལ་ཚིག_ཐ་དད་པ+སྤྲས_འདས་པ།_ཐ་དད་པ
སྤྲིང | སྤྲིངས_མ་འོངས་པ།_ཐ་དད་པ+སྤྲིང_མ་འོངས་པ།_ཐ་དད་པ+སྤྲིང_ད་ལྟ་བ།_ཐ་དད་པ+སྤྲིངས_ད་ལྟ་བ།_ཐ་དད་པ
སྤྲིངས | སྤྲིང_འདས་པ།_ཐ་དད་པ+སྤྲིང_སྐུལ་ཚིག_ཐ་དད་པ+སྤྲིངས_འདས་པ།_ཐ་དད་པ+སྤྲིངས_སྐུལ་ཚིག_ཐ་དད་པ
སྤྲིབས | གཟུགས་མི་འགྱུར་བ_ཐ་མི་དད་པ
སྤྲུག | སྤྲུག_ད་ལྟ་བ།_ཐ་དད་པ+སྤྲུགས_ད་ལྟ་བ།_ཐ་དད་པ+སྤྲུག_མ་འོངས་པ།_ཐ་དད་པ+སྤྲུག_འདས་པ།_ཐ་དད་པ+སྤྲུགས_མ་འོངས་པ།_ཐ་དད་པ
སྤྲུགས | སྤྲུགས_སྐུལ་ཚིག_ཐ་དད་པ+སྤྲུགས_འདས་པ།_ཐ་དད་པ
སྤྲུལ | གཟུགས་མི་འགྱུར་བ_ཐ་དད་པ
སྤྲོ | སྤྲོས_མ་འོངས་པ།_###+སྤྲོ_ད་ལྟ་བ།_ཐ་དད་པ+སྤྲོ_མ་འོངས་པ།_ཐ་དད་པ+སྤྲོས_ད་ལྟ་བ།_###
སྤྲོད | སྤྲད_ད་ལྟ་བ།_ཐ་དད་པ+སྤྲད_སྐུལ་ཚིག_ཐ་དད་པ+སྤྲོད_ད་ལྟ་བ།_###+སྤྲོད_སྐུལ་ཚིག_ཐ་དད་པ+སྤྲོད_སྐུལ་ཚིག_###+སྤྲོད_ད་ལྟ་བ།_ཐ་དད་པ
སྤྲོས | སྤྲོས_འདས་པ།_###+སྤྲོས_སྐུལ་ཚིག_###+སྤྲོ_འདས་པ།_ཐ་དད་པ+སྤྲོ_སྐུལ་ཚིག_ཐ་དད་པ
སྦ | སྦེད_མ་འོངས་པ།_ཐ་དད་པ
སྦག | སྦག_མ་འོངས་པ།_###+སྦག_མ་འོངས་པ།_ཐ་དད་པ+སྦག_ད་ལྟ་བ།_###+སྦག_ད་ལྟ་བ།_ཐ་དད་པ
སྦགས | སྦག_འདས་པ།_ཐ་དད་པ+སྦག_འདས་པ།_###
སྦང | སྦོང_མ་འོངས་པ།_ཐ་དད་པ
སྦངས | སྦོང_འདས་པ།_ཐ་དད་པ
སྦམ | སྦོམ_མ་འོངས་པ།_ཐ་དད་པ
སྦམས | སྦོམ_འདས་པ།_ཐ་དད་པ
སྦར | སྦར_འདས་པ།_ཐ་དད་པ+སྦར_མ་འོངས་པ།_ཐ་དད་པ+སྦོར_མ་འོངས་པ།_ཐ་དད་པ+སྦོར_མ་འོངས་པ།_###+སྦོར_འདས་པ།_###+སྦོར_འདས་པ།_ཐ་དད་པ
སྦས | སྦེད_འདས་པ།_ཐ་དད་པ
སྦིར | གཟུགས་མི་འགྱུར་བ_ཐ་དད་པ
སྦུབ | སྦུབ_མ་འོངས་པ།_ཐ་དད་པ+སྦུབས_མ་འོངས་པ།_ཐ་དད་པ+སྦུབ_ད་ལྟ་བ།_ཐ་དད་པ+སྦུབས_ད་ལྟ་བ།_ཐ་དད་པ
སྦུབས | སྦུབས_འདས་པ།_ཐ་དད་པ+སྦུབས_སྐུལ་ཚིག_ཐ་དད་པ+སྦུབ_སྐུལ་ཚིག_ཐ་དད་པ+སྦུབ_འདས་པ།_ཐ་དད་པ
སྦེད | སྦེད_ད་ལྟ་བ།_ཐ་དད་པ
སྦོ | སྦོ_ད་ལྟ་བ།_ཐ་དད་པ+སྦོར_སྐུལ་ཚིག_ཐ་དད་པ+སྦར_སྐུལ་ཚིག_ཐ་དད་པ+སྦོ_མ་འོངས་པ།_ཐ་དད་པ+སྦོར_སྐུལ་ཚིག_###
སྦོགས | སྦག_སྐུལ་ཚིག_ཐ་དད་པ+སྦག_སྐུལ་ཚིག_###
སྦོང | སྦོང_ད་ལྟ་བ།_ཐ་དད་པ
སྦོངས | སྦོང_སྐུལ་ཚིག_ཐ་དད་པ
སྦོམ | སྦོམ_ད་ལྟ་བ།_ཐ་དད་པ
སྦོམས | སྦོམ_སྐུལ་ཚིག_ཐ་དད་པ
སྦོར | སྦར_ད་ལྟ་བ།_ཐ་དད་པ+སྦོར_ད་ལྟ་བ།_ཐ་དད་པ+སྦོར_ད་ལྟ་བ།_###
སྦོས | སྦེད_སྐུལ་ཚིག_ཐ་དད་པ+སྦོ_འདས་པ།_ཐ་དད་པ
སྦྱང | སྦྱོང_མ་འོངས་པ།_ཐ་དད་པ+སྦྱོང_མ་འོངས་པ།_###
སྦྱངས | སྦྱོང_འདས་པ།_ཐ་དད་པ+སྦྱོང_འདས་པ།_###
སྦྱར | སྦྱོར_འདས་པ།_ཐ་དད་པ+སྦྱར_འདས་པ།_ཐ་དད་པ+སྦྱོར_མ་འོངས་པ།_ཐ་དད་པ+སྦྱོར_མ་འོངས་པ།_###+སྦྱར_མ་འོངས་པ།_ཐ་དད་པ+སྦྱོར_འདས་པ།_###
སྦྱིག | གཟུགས་མི་འགྱུར་བ_ཐ་མི་དད་པ
སྦྱིན | སྦྱིན_ད་ལྟ་བ།_ཐ་དད་པ+བྱིན_མ་འོངས་པ།_ཐ་དད་པ+བྱིན_ད་ལྟ་བ།_ཐ་དད་པ+སྦྱིན_མ་འོངས་པ།_ཐ་དད་པ
སྦྱོང | སྦྱོང_ད་ལྟ་བ།_###+སྦྱོང_ད་ལྟ་བ།_ཐ་དད་པ
སྦྱོངས | སྦྱོང_སྐུལ་ཚིག_###+སྦྱོང_སྐུལ་ཚིག_ཐ་དད་པ
སྦྱོར | སྦྱར_ད་ལྟ་བ།_ཐ་དད་པ+སྦྱར_སྐུལ་ཚིག_ཐ་དད་པ+སྦྱོར_སྐུལ་ཚིག_ཐ་དད་པ+སྦྱོར_ད་ལྟ་བ།_###+སྦྱོར_ད་ལྟ་བ།_ཐ་དད་པ+སྦྱོར_སྐུལ་ཚིག_###
སྦྲག | སྦྲག_མ་འོངས་པ།_ཐ་དད་པ+སྦྲག_མ་འོངས་པ།_###+སྦྲག_ད་ལྟ་བ།_ཐ་དད་པ+སྦྲག_ད་ལྟ་བ།_###
སྦྲགས | སྦྲག_འདས་པ།_###+སྦྲག_འདས་པ།_ཐ་དད་པ
སྦྲད | འབྲད_འབྲི་ཚུལ+བྱ་ཚིག_ཐ་དད་པ
སྦྲན | སྦྲོན_མ་འོངས་པ།_ཐ་དད་པ+སྦྲོན_འདས་པ།_ཐ་དད་པ+སྦྲན_འདས་པ།_ཐ་དད་པ+སྦྲོན_འདས་པ།_###+སྦྲོན_མ་འོངས་པ།_###+སྦྲན_མ་འོངས་པ།_ཐ་དད་པ
སྦྲིད | གཟུགས་མི་འགྱུར་བ_ཐ་མི་དད་པ+བྱ་ཚིག_###
སྦྲུ | སྦྲུད_མ་འོངས་པ།_ཐ་དད་པ+སྦྲུས_མ་འོངས་པ།_ཐ་དད་པ
སྦྲུད | སྦྲུས_ད་ལྟ་བ།_ཐ་དད་པ+སྦྲུད_ད་ལྟ་བ།_ཐ་དད་པ
སྦྲུམ | གཟུགས་མི་འགྱུར་བ_ཐ་མི་དད་པ
སྦྲུས | སྦྲུད_སྐུལ་ཚིག_ཐ་དད་པ+སྦྲུད_འདས་པ།_ཐ་དད་པ+སྦྲུས_འདས་པ།_ཐ་དད་པ+སྦྲུས_སྐུལ་ཚིག_ཐ་དད་པ
སྦྲེང | སྦྲེང_ད་ལྟ་བ།_###+སྦྲེང_ད་ལྟ་བ།_ཐ་དད་པ+སྦྲེང_མ་འོངས་པ།_ཐ་དད་པ+སྦྲེངས_མ་འོངས་པ།_ཐ་དད་པ+སྦྲེང_མ་འོངས་པ།_###+སྦྲེངས_ད་ལྟ་བ།_ཐ་དད་པ
སྦྲེངས | སྦྲེངས_སྐུལ་ཚིག_ཐ་དད་པ+སྦྲེང_སྐུལ་ཚིག_###+སྦྲེངས_འདས་པ།_ཐ་དད་པ+སྦྲེང_འདས་པ།_ཐ་དད་པ+སྦྲེང_འདས་པ།_###+སྦྲེང_སྐུལ་ཚིག_ཐ་དད་པ
སྦྲེབ | སྦྲེབ_མ་འོངས་པ།_ཐ་མི་དད་པ+སྦྲེབ_ད་ལྟ་བ།_###+སྦྲེབ_མ་འོངས་པ།_###+སྦྲེབ_ད་ལྟ་བ།_ཐ་མི་དད་པ
སྦྲེབས | སྦྲེབ_འདས་པ།_###+སྦྲེབ_འདས་པ།_ཐ་མི་དད་པ
སྦྲེལ | གཟུགས་མི་འགྱུར་བ_ཐ་དད་པ
སྦྲོག | བྱ་ཚིག_ཐ་དད་པ
སྦྲོགས | སྦྲག_སྐུལ་ཚིག_###+སྦྲག_སྐུལ་ཚིག_ཐ་དད་པ
སྦྲོན | སྦྲན_ད་ལྟ་བ།_ཐ་དད་པ+སྦྲན_སྐུལ་ཚིག_ཐ་དད་པ+སྦྲོན_ད་ལྟ་བ།_###+གཟུགས་མི་འགྱུར་བ_ཐ་དད་པ+སྦྲོན_སྐུལ་ཚིག_ཐ་དད་པ+སྦྲོན_ད་ལྟ་བ།_ཐ་དད་པ+སྦྲོན_སྐུལ་ཚིག_###
སྨད | སྨོད_འདས་པ།_ཐ་དད་པ+སྨད_མ་འོངས་པ།_ཐ་དད་པ+སྨད_འདས་པ།_ཐ་དད་པ+སྨོད_མ་འོངས་པ།_ཐ་དད་པ+སྨོད_མ་འོངས་པ།_###+སྨོད_འདས་པ།_###
སྨན | གཟུགས་མི་འགྱུར་བ_ཐ་མི་དད་པ
སྨིན | གཟུགས་མི་འགྱུར་བ_ཐ་མི་དད་པ+བྱ་ཚིག_###
སྨོད | སྨོད_ད་ལྟ་བ།_###+སྨོད_སྐུལ་ཚིག_###+སྨད_སྐུལ་ཚིག_ཐ་དད་པ+སྨོད_སྐུལ་ཚིག_ཐ་དད་པ+སྨོད_ད་ལྟ་བ།_ཐ་དད་པ+སྨད_ད་ལྟ་བ།_ཐ་དད་པ
སྨོན | གཟུགས་མི་འགྱུར་བ_ཐ་དད་པ
སྨོས | སྨྲ_འབྲི་ཚུལ+བྱ་ཚིག_###+གཟུགས་མི་འགྱུར་བ_ཐ་དད་པ+སྨྲ_སྐུལ་ཚིག_ཐ་དད་པ
སྨྱང | བྱ་ཚིག_ཐ་དད་པ+རྨྱང_འབྲི་ཚུལ
སྨྱུགས | བྱ་ཚིག_###+གཟུགས་མི་འགྱུར་བ_ཐ་དད་པ
སྨྱུང | སྨྱུང_ད་ལྟ་བ།_ཐ་དད་པ+སྨྱུང_མ་འོངས་པ།_ཐ་དད་པ+སྨྱུངས_ད་ལྟ་བ།_ཐ་དད་པ+སྨྱུངས_མ་འོངས་པ།_ཐ་དད་པ
སྨྱུངས | སྨྱུང_སྐུལ་ཚིག_ཐ་དད་པ+སྨྱུང_འདས་པ།_ཐ་དད་པ+སྨྱུངས_འདས་པ།_ཐ་དད་པ+སྨྱུངས_སྐུལ་ཚིག_ཐ་དད་པ
སྨྱུར | གཟུགས་མི་འགྱུར་བ_ཐ་དད་པ
སྨྱོ | སྨྱོ_མ་འོངས་པ།_ཐ་མི་དད་པ+སྨྱོ_ད་ལྟ་བ།_ཐ་མི་དད་པ
སྨྱོས | སྨྱོ_འདས་པ།_ཐ་མི་དད་པ
སྨྲ | སྨྲ_མ་འོངས་པ།_ཐ་དད་པ+སྨྲ_ད་ལྟ་བ།_ཐ་དད་པ
སྨྲས | སྨྲ_འདས་པ།_ཐ་དད་པ
སྨྲེང | བྱ་ཚིག_###+བྱ་ཚིག_ཐ་མི་དད་པ
སྨྲོས | སྨྲ_སྐུལ་ཚིག_འབྲི་ཚུལ
སྩེལ | བྱ་ཚིག_ཐ་དད་པ
སྩོལ | སྩོལ_སྐུལ་ཚིག_ཐ་དད་པ+བསྩལ_ད་ལྟ་བ།_ཐ་དད་པ+བསྩལ_སྐུལ་ཚིག_ཐ་དད་པ+སྩོལ_ད་ལྟ་བ།_ཐ་དད་པ
སྲད | བསྲད_ད་ལྟ་བ།_ཐ་དད་པ+སྲད_ད་ལྟ་བ།_ཐ་མི་དད་པ
སྲན | སྲན_ད་ལྟ་བ།_ཐ་དད་པ+བསྲན_ད་ལྟ་བ།_ཐ་དད་པ
སྲབ | སྲབ_ད་ལྟ་བ།_ཐ་མི་དད་པ
སྲི | སྲི_ད་ལྟ་བ།_ཐ་དད་པ
སྲིང | སྲིང_ད་ལྟ་བ།_###+སྲིང_ད་ལྟ་བ།_ཐ་དད་པ
སྲིངས | སྲིང_སྐུལ་ཚིག_ཐ་དད་པ+སྲིང_སྐུལ་ཚིག_###
སྲིབ | བསྲིབས_ད་ལྟ་བ།_ཐ་དད་པ+སྲིབ_ད་ལྟ་བ།_ཐ་དད་པ
སྲིབས | བསྲིབས_སྐུལ་ཚིག_ཐ་དད་པ+སྲིབ_སྐུལ་ཚིག_ཐ་དད་པ
སྲིས | སྲི_སྐུལ་ཚིག_ཐ་དད་པ
སྲུང | སྲུང_ད་ལྟ་བ།_ཐ་དད་པ+སྲུང_ད་ལྟ་བ།_###
སྲུངས | སྲུང_སྐུལ་ཚིག_###+སྲུང_སྐུལ་ཚིག_ཐ་དད་པ
སྲུན | སྲུན_ད་ལྟ་བ།_ཐ་དད་པ+བསྲུན_སྐུལ་ཚིག_ཐ་དད་པ+བསྲུན_ད་ལྟ་བ།_ཐ་དད་པ+སྲུན_སྐུལ་ཚིག_ཐ་དད་པ
སྲུབ | སྲུབ_ད་ལྟ་བ།_ཐ་དད་པ+སྲུབ_ད་ལྟ་བ།_###
སྲུབས | སྲུབ_སྐུལ་ཚིག_ཐ་དད་པ+སྲུབ_སྐུལ་ཚིག_###
སྲུལ | བསྲུལ_སྐུལ་ཚིག_ཐ་དད་པ+སྲུལ_སྐུལ་ཚིག_ཐ་དད་པ+སྲུལ_ད་ལྟ་བ།_ཐ་དད་པ+བསྲུལ_ད་ལྟ་བ།_ཐ་དད་པ
སྲེ | སྲེ_ད་ལྟ་བ།_ཐ་དད་པ
སྲེག | སྲེག_ད་ལྟ་བ།_###+སྲེག_ད་ལྟ་བ།_ཐ་དད་པ
སྲེགས | སྲེག_སྐུལ་ཚིག_ཐ་དད་པ+སྲེག_སྐུལ་ཚིག_###
སྲེད | གཟུགས་མི་འགྱུར་བ_ཐ་དད་པ
སྲེལ | བསྲེལ_ད་ལྟ་བ།_ཐ་དད་པ+བསྲེལ_སྐུལ་ཚིག_ཐ་དད་པ+སྲེལ_ད་ལྟ་བ།_ཐ་དད་པ+སྲེལ_སྐུལ་ཚིག_ཐ་དད་པ
སྲེས | སྲེ_སྐུལ་ཚིག_ཐ་དད་པ
སྲོ | སྲོ_ད་ལྟ་བ།_ཐ་དད་པ
སྲོགས | སྲེག_སྐུལ་ཚིག_འབྲི་ཚུལ
སྲོང | སྲོང_ད་ལྟ་བ།_ཐ་དད་པ+སྲོང_ད་ལྟ་བ།_###
སྲོངས | སྲོང_སྐུལ་ཚིག_###+སྲོང_སྐུལ་ཚིག_ཐ་དད་པ
སྲོད | སྲད_སྐུལ་ཚིག_ཐ་མི་དད་པ+བསྲད_སྐུལ་ཚིག_ཐ་དད་པ
སྲོན | བསྲན_སྐུལ་ཚིག_ཐ་དད་པ+སྲན_སྐུལ་ཚིག_ཐ་དད་པ
སྲོས | སྲོ_སྐུལ་ཚིག_ཐ་དད་པ
སླུ | སླུ_ད་ལྟ་བ།_ཐ་དད་པ
སླུས | སླུ_སྐུལ་ཚིག_ཐ་དད་པ
སླེ | སླེ_ད་ལྟ་བ།_ཐ་དད་པ
སླེབ | སླེབ_མ་འོངས་པ།_ཐ་དད་པ+སླེབ_ད་ལྟ་བ།_ཐ་དད་པ
སླེབས | སླེབ_འདས་པ།_ཐ་དད་པ
སླེས | སླེ_སྐུལ་ཚིག_ཐ་དད་པ
སློག | སློག_ད་ལྟ་བ།_###+སློག_ད་ལྟ་བ།_ཐ་དད་པ
སློགས | སློག_སྐུལ་ཚིག_ཐ་དད་པ+སློག_སྐུལ་ཚིག_###
སློང | སློང_ད་ལྟ་བ།_ཐ་དད་པ+སློང_ད་ལྟ་བ།_###
སློངས | སློང_སྐུལ་ཚིག_ཐ་དད་པ+སློང_སྐུལ་ཚིག_###
སློད | སློད_ད་ལྟ་བ།_###+བསླད_ད་ལྟ་བ།_ཐ་དད་པ+བསླད_སྐུལ་ཚིག_ཐ་དད་པ+སློད_སྐུལ་ཚིག_###+སློད_སྐུལ་ཚིག_ཐ་དད་པ+སློད_ད་ལྟ་བ།_ཐ་དད་པ
སློན | སློན_སྐུལ་ཚིག_ཐ་དད་པ+བསླན_སྐུལ་ཚིག_ཐ་དད་པ+བསླན_ད་ལྟ་བ།_ཐ་དད་པ+སློན_སྐུལ་ཚིག_###+སློན_ད་ལྟ་བ།_ཐ་དད་པ+སློན_ད་ལྟ་བ།_###
སློབ | སློབ_ད་ལྟ་བ།_ཐ་དད་པ
སློབས | སློབ_སྐུལ་ཚིག_ཐ་དད་པ
སློས | བྱ་ཚིག_###
ཧད | གཟུགས་མི་འགྱུར་བ_ཐ་མི་དད་པ
ཧལ | གཟུགས་མི་འགྱུར་བ_ཐ་མི་དད་པ
ཧོལ | གཟུགས་མི་འགྱུར་བ_ཐ་དད་པ
ཧྲང | ཧྲང_འདས་པ།_ཐ་དད་པ+ཧྲང_ད་ལྟ་བ།_###+ཧྲང_འདས་པ།_###+ཧྲང_ད་ལྟ་བ།_ཐ་དད་པ+ཧྲང_མ་འོངས་པ།_###+ཧྲང_མ་འོངས་པ།_ཐ་དད་པ
ཧྲད | ཧྲད_ད་ལྟ་བ།_ཐ་དད་པ+ཧྲད_འདས་པ།_ཐ་དད་པ+ཧྲད_མ་འོངས་པ།_ཐ་དད་པ
ཧྲོངས | ཧྲང_སྐུལ་ཚིག_###+ཧྲང_སྐུལ་ཚིག_ཐ་དད་པ
ཧྲོད | ཧྲད_སྐུལ་ཚིག_ཐ་དད་པ
